ProfileNumber__c,Contact__r.CustomerID__c,Tier__c,Join_Date__c,Points_Accrued__c,Points_Spent__c,Points_Balance__c
100007,1,Member,2021-07-06,396387,27201,369186
100014,2,Member,2021-06-01,408568,55345,353223
100021,3,Explorer,2021-01-08,877001,223058,653943
100028,4,Member,2021-04-03,226253,52346,173907
100035,5,Explorer,2021-02-25,792394,180087,612307
100042,6,Member,2020-09-15,411898,286179,125719
100049,7,Explorer,2020-08-22,650480,488169,162311
100056,8,Explorer,2021-06-05,952394,642244,310150
100063,9,Member,2021-03-30,344134,325304,18830
100070,10,Member,2021-06-14,253964,184820,69144
100077,11,Member,2020-07-04,258612,7122,251490
100084,12,Member,2022-01-08,489515,247760,241755
100091,13,Explorer,2021-06-29,711419,249664,461755
100098,14,Explorer,2020-10-27,751302,129569,621733
100105,15,Member,2022-05-02,323373,10709,312664
100112,16,Explorer,2021-12-16,651669,599974,51695
100119,17,Member,2022-02-16,158988,128530,30458
100126,18,Explorer,2021-05-14,979823,207822,772001
100133,19,Explorer,2021-06-16,765402,670322,95080
100140,20,Member,2021-07-10,135648,135534,114
100147,21,Explorer,2022-04-14,772272,359484,412788
100154,22,Explorer,2022-04-20,632324,112457,519867
100161,23,Member,2021-07-07,157961,82712,75249
100168,24,Explorer,2021-05-06,791726,340522,451204
100175,25,Explorer,2022-04-18,799840,786486,13354
100182,26,Member,2020-06-30,202193,124563,77630
100189,27,Explorer,2021-10-01,786485,89131,697354
100196,28,Explorer,2021-06-08,784023,89820,694203
100203,29,Explorer,2021-05-22,751456,509693,241763
100210,30,Member,2021-03-04,143785,70807,72978
100217,31,Explorer,2020-08-04,783139,528079,255060
100224,32,Explorer,2021-06-13,671121,238081,433040
100231,33,Explorer,2020-06-10,935906,883770,52136
100238,34,Member,2021-04-14,143449,84830,58619
100245,35,Member,2020-10-26,412274,258087,154187
100252,36,Explorer,2021-10-13,963234,514523,448711
100259,37,Member,2021-09-13,227203,44317,182886
100266,38,Explorer,2021-12-20,847551,243321,604230
100273,39,Member,2020-12-20,181481,61830,119651
100280,40,Member,2021-06-03,364704,273423,91281
100287,41,Explorer,2020-11-04,638473,527768,110705
100294,42,Explorer,2020-09-27,952865,693786,259079
100301,43,Member,2021-04-05,138669,112927,25742
100308,44,Member,2021-11-14,185394,18340,167054
100315,45,Explorer,2021-01-23,724979,178517,546462
100322,46,Member,2020-11-06,404352,14312,390040
100329,47,Explorer,2020-07-04,681656,658343,23313
100336,48,Member,2022-05-23,218219,87119,131100
100343,49,Member,2021-01-10,128534,88196,40338
100350,50,Explorer,2020-12-13,881985,535741,346244
100357,51,Explorer,2020-06-09,845304,574869,270435
100364,52,Member,2022-03-19,117920,58704,59216
100371,53,Member,2021-06-06,391935,81664,310271
100378,54,Explorer,2021-04-13,999099,958024,41075
100385,55,Explorer,2021-04-15,645307,494670,150637
100392,56,Explorer,2021-04-19,764144,112188,651956
100399,57,Member,2020-07-07,217901,49402,168499
100406,58,Member,2022-01-31,311125,52404,258721
100413,59,Explorer,2020-10-14,639235,397264,241971
100420,60,Member,2021-04-09,401354,307471,93883
100427,61,Explorer,2021-10-26,616328,194152,422176
100434,62,Explorer,2021-01-05,799366,62058,737308
100441,63,Member,2022-04-24,454352,48799,405553
100448,64,Explorer,2020-09-01,947063,604089,342974
100455,65,Member,2020-12-04,201259,141527,59732
100462,66,Member,2021-03-23,458882,251455,207427
100469,67,Member,2021-05-19,486399,267398,219001
100476,68,Explorer,2021-12-13,623910,320402,303508
100483,69,Explorer,2021-08-25,827225,102698,724527
100490,70,Explorer,2020-12-22,844441,215435,629006
100497,71,Member,2021-10-11,116639,46883,69756
100504,72,Explorer,2022-01-16,842789,727807,114982
100511,73,Member,2021-07-13,440536,308153,132383
100518,74,Explorer,2021-12-02,609697,601660,8037
100525,75,Member,2021-09-14,235634,52741,182893
100532,76,Explorer,2020-08-21,817992,452978,365014
100539,77,Member,2021-03-22,306434,163430,143004
100546,78,Explorer,2021-08-30,976446,128585,847861
100553,79,Explorer,2021-05-07,827844,621928,205916
100560,80,Explorer,2022-04-14,822987,2423,820564
100567,81,Explorer,2021-07-14,859986,488788,371198
100574,82,Explorer,2020-12-03,895605,471018,424587
100581,83,Explorer,2020-06-19,942544,332966,609578
100588,84,Member,2021-09-01,139791,86412,53379
100595,85,Member,2022-01-30,450704,216835,233869
100602,86,Member,2021-02-04,235068,7744,227324
100609,87,Explorer,2021-02-23,749697,176882,572815
100616,88,Explorer,2022-03-09,717637,679516,38121
100623,89,Explorer,2020-08-27,917804,403165,514639
100630,90,Member,2021-06-23,181979,55685,126294
100637,91,Explorer,2021-06-14,957320,89428,867892
100644,92,Explorer,2022-02-08,686466,429584,256882
100651,93,Member,2022-04-11,429583,241868,187715
100658,94,Member,2021-11-23,391384,17996,373388
100665,95,Explorer,2022-05-09,692883,429547,263336
100672,96,Member,2020-08-09,113091,95082,18009
100679,97,Explorer,2021-07-15,759519,128230,631289
100686,98,Explorer,2021-02-14,712415,114506,597909
100693,99,Member,2021-05-23,323923,52568,271355
100700,100,Member,2021-11-10,275458,166128,109330
100707,101,Explorer,2020-11-07,953021,224523,728498
100714,102,Member,2022-06-07,129886,62082,67804
100721,103,Member,2020-08-24,170007,54636,115371
100728,104,Explorer,2022-02-13,845838,401753,444085
100735,105,Explorer,2020-08-18,895665,409049,486616
100742,106,Explorer,2021-10-12,741500,139135,602365
100749,107,Explorer,2021-12-03,730280,491864,238416
100756,108,Member,2020-11-04,334908,136514,198394
100763,109,Explorer,2021-08-12,719343,398605,320738
100770,110,Explorer,2021-07-28,634058,193106,440952
100777,111,Explorer,2021-12-05,925213,833781,91432
100784,112,Member,2022-01-03,195625,148662,46963
100791,113,Member,2020-07-22,341333,53094,288239
100798,114,Member,2022-04-25,167810,148754,19056
100805,115,Member,2022-04-13,414119,131007,283112
100812,116,Explorer,2021-01-18,704911,500523,204388
100819,117,Member,2020-06-28,275969,251048,24921
100826,118,Member,2021-08-27,101840,46206,55634
100833,119,Member,2021-06-06,395830,168262,227568
100840,120,Explorer,2021-06-02,779735,548026,231709
100847,121,Explorer,2020-06-20,785772,167726,618046
100854,122,Explorer,2020-11-04,687741,636135,51606
100861,123,Member,2020-10-18,350452,216621,133831
100868,124,Member,2020-08-27,126980,120482,6498
100875,125,Explorer,2020-11-10,677486,345029,332457
100882,126,Member,2021-11-30,281384,274585,6799
100889,127,Member,2021-11-07,401014,229128,171886
100896,128,Explorer,2021-07-01,696218,623083,73135
100903,129,Explorer,2020-06-27,949193,477409,471784
100910,130,Member,2021-10-10,162551,150622,11929
100917,131,Explorer,2020-09-07,990966,970944,20022
100924,132,Member,2021-10-07,374243,226084,148159
100931,133,Explorer,2021-01-11,676585,97805,578780
100938,134,Member,2021-04-18,430015,342675,87340
100945,135,Member,2021-01-29,478794,189343,289451
100952,136,Member,2021-04-22,248744,194677,54067
100959,137,Explorer,2021-11-29,834348,679393,154955
100966,138,Explorer,2020-09-16,826875,342513,484362
100973,139,Member,2020-12-28,306155,19429,286726
100980,140,Member,2021-12-16,242310,236337,5973
100987,141,Explorer,2020-09-15,726133,33573,692560
100994,142,Member,2020-12-21,407003,83684,323319
101001,143,Member,2022-01-30,302517,128024,174493
101008,144,Explorer,2021-05-30,812355,641490,170865
101015,145,Member,2021-04-21,277842,172096,105746
101022,146,Explorer,2021-03-18,815758,71846,743912
101029,147,Explorer,2021-07-20,844514,366731,477783
101036,148,Explorer,2020-08-21,618665,378539,240126
101043,149,Member,2021-05-20,205569,18719,186850
101050,150,Member,2022-02-20,486149,384122,102027
101057,151,Explorer,2022-01-16,694742,443592,251150
101064,152,Explorer,2021-02-08,840783,265475,575308
101071,153,Explorer,2021-07-03,935452,465012,470440
101078,154,Member,2021-11-20,108079,45521,62558
101085,155,Explorer,2021-03-09,979398,322564,656834
101092,156,Explorer,2021-12-27,868697,482006,386691
101099,157,Explorer,2021-05-20,720708,667236,53472
101106,158,Member,2021-11-29,134365,95604,38761
101113,159,Member,2021-08-03,119579,51396,68183
101120,160,Member,2021-06-09,412805,341420,71385
101127,161,Member,2022-01-21,197486,188677,8809
101134,162,Explorer,2020-07-19,924133,474369,449764
101141,163,Member,2021-06-13,354058,55479,298579
101148,164,Explorer,2021-09-01,769145,620886,148259
101155,165,Member,2020-11-13,458176,669,457507
101162,166,Explorer,2021-08-30,747621,222384,525237
101169,167,Member,2021-10-16,460672,305061,155611
101176,168,Explorer,2021-06-16,659627,655924,3703
101183,169,Member,2020-09-04,386055,2541,383514
101190,170,Explorer,2021-11-02,681544,658139,23405
101197,171,Member,2022-01-26,147056,15175,131881
101204,172,Member,2020-07-22,337417,232977,104440
101211,173,Member,2021-11-27,367474,105519,261955
101218,174,Member,2021-07-21,476031,260006,216025
101225,175,Explorer,2021-05-25,721679,565587,156092
101232,176,Explorer,2021-08-04,775712,103531,672181
101239,177,Member,2021-10-25,166868,121699,45169
101246,178,Explorer,2020-12-20,894407,224168,670239
101253,179,Member,2020-06-19,265457,123808,141649
101260,180,Member,2021-01-21,153361,64984,88377
101267,181,Member,2020-10-24,333395,290316,43079
101274,182,Member,2020-10-01,232244,76086,156158
101281,183,Member,2022-05-11,126638,17063,109575
101288,184,Explorer,2022-03-31,944434,116877,827557
101295,185,Member,2020-12-15,142099,93065,49034
101302,186,Member,2021-10-15,397970,356549,41421
101309,187,Explorer,2021-08-18,849020,35004,814016
101316,188,Explorer,2020-11-12,703605,120053,583552
101323,189,Member,2020-07-06,344513,39215,305298
101330,190,Member,2020-07-24,213025,109547,103478
101337,191,Member,2021-08-19,454168,288931,165237
101344,192,Explorer,2022-05-02,789764,510023,279741
101351,193,Member,2022-02-25,295406,131440,163966
101358,194,Explorer,2022-02-11,722738,363070,359668
101365,195,Explorer,2020-08-05,961846,624043,337803
101372,196,Explorer,2021-01-18,759145,406200,352945
101379,197,Explorer,2022-05-17,755848,509667,246181
101386,198,Explorer,2021-09-01,862201,712495,149706
101393,199,Explorer,2020-11-09,638075,270253,367822
101400,200,Explorer,2022-01-25,960275,543214,417061
101407,201,Explorer,2021-06-17,960784,359632,601152
101414,202,Member,2021-11-14,388512,229651,158861
101421,203,Explorer,2020-11-18,720399,687977,32422
101428,204,Member,2020-12-11,480224,51065,429159
101435,205,Member,2021-03-05,185345,28405,156940
101442,206,Explorer,2021-10-07,896992,882305,14687
101449,207,Member,2020-07-12,278969,51676,227293
101456,208,Explorer,2021-10-15,635795,389613,246182
101463,209,Member,2021-03-19,105192,98324,6868
101470,210,Member,2022-02-13,161798,52890,108908
101477,211,Explorer,2021-05-20,890563,777151,113412
101484,212,Explorer,2021-06-08,921751,484495,437256
101491,213,Explorer,2021-02-12,806311,715819,90492
101498,214,Member,2020-10-27,110459,94203,16256
101505,215,Explorer,2021-04-24,914712,371832,542880
101512,216,Explorer,2022-04-17,648610,430175,218435
101519,217,Explorer,2021-10-23,914813,250163,664650
101526,218,Explorer,2021-08-07,954554,592982,361572
101533,219,Member,2021-05-13,245313,3776,241537
101540,220,Member,2021-11-21,207725,182949,24776
101547,221,Explorer,2021-09-14,925140,425660,499480
101554,222,Member,2021-05-07,310475,280856,29619
101561,223,Member,2021-01-05,120788,93637,27151
101568,224,Explorer,2020-12-18,739689,544366,195323
101575,225,Explorer,2022-03-30,844386,817762,26624
101582,226,Member,2020-08-24,152737,128532,24205
101589,227,Member,2022-01-17,278586,33481,245105
101596,228,Member,2020-10-15,497678,298349,199329
101603,229,Explorer,2021-05-10,960330,939800,20530
101610,230,Member,2021-04-20,128968,43368,85600
101617,231,Explorer,2022-01-31,766689,610057,156632
101624,232,Member,2021-06-06,135102,65635,69467
101631,233,Member,2020-09-23,364181,128662,235519
101638,234,Explorer,2021-12-14,743571,402030,341541
101645,235,Member,2020-10-05,423100,355260,67840
101652,236,Explorer,2020-11-13,619390,405739,213651
101659,237,Explorer,2021-10-11,622159,380734,241425
101666,238,Explorer,2020-08-02,808144,441306,366838
101673,239,Explorer,2021-11-13,614848,281017,333831
101680,240,Member,2020-07-11,275482,43928,231554
101687,241,Member,2020-12-02,453246,168174,285072
101694,242,Explorer,2021-02-11,815491,768262,47229
101701,243,Member,2022-05-07,278636,59716,218920
101708,244,Explorer,2022-05-26,818450,409886,408564
101715,245,Member,2020-06-30,368199,29108,339091
101722,246,Member,2021-06-05,308827,200145,108682
101729,247,Explorer,2022-01-21,816133,329194,486939
101736,248,Explorer,2020-10-21,843977,169042,674935
101743,249,Member,2021-11-02,425033,224296,200737
101750,250,Member,2022-03-08,410031,363845,46186
101757,251,Member,2020-10-31,108443,26426,82017
101764,252,Explorer,2022-04-30,864086,664733,199353
101771,253,Explorer,2020-08-17,981129,432805,548324
101778,254,Member,2021-08-31,244103,36238,207865
101785,255,Explorer,2021-03-01,973856,879971,93885
101792,256,Member,2022-05-20,399461,361037,38424
101799,257,Member,2022-03-13,391511,302734,88777
101806,258,Member,2021-05-04,165239,57223,108016
101813,259,Member,2021-05-04,338587,62800,275787
101820,260,Explorer,2020-09-09,917405,330978,586427
101827,261,Member,2021-01-29,301884,49254,252630
101834,262,Explorer,2022-03-20,964605,578041,386564
101841,263,Explorer,2022-01-09,683867,197296,486571
101848,264,Explorer,2020-11-07,978735,759941,218794
101855,265,Explorer,2022-01-06,652953,530736,122217
101862,266,Member,2021-05-15,186321,125133,61188
101869,267,Member,2020-10-29,130736,111695,19041
101876,268,Member,2021-11-27,477257,242341,234916
101883,269,Explorer,2020-10-18,608021,253627,354394
101890,270,Member,2022-05-13,168940,3493,165447
101897,271,Member,2021-12-03,209416,101537,107879
101904,272,Explorer,2021-04-08,819484,108490,710994
101911,273,Explorer,2021-02-02,969357,675794,293563
101918,274,Explorer,2020-08-09,754510,125239,629271
101925,275,Explorer,2021-07-19,780285,6618,773667
101932,276,Member,2022-04-06,137247,69462,67785
101939,277,Explorer,2022-02-03,604687,311090,293597
101946,278,Member,2020-10-26,263889,39620,224269
101953,279,Explorer,2021-08-01,925262,844616,80646
101960,280,Member,2021-03-24,330703,322613,8090
101967,281,Explorer,2020-06-11,858342,108432,749910
101974,282,Explorer,2021-11-23,766567,504580,261987
101981,283,Explorer,2022-02-03,864512,104248,760264
101988,284,Explorer,2021-04-26,993329,622537,370792
101995,285,Explorer,2020-12-27,725967,82440,643527
102002,286,Explorer,2022-06-07,939229,271582,667647
102009,287,Explorer,2021-03-24,709438,277212,432226
102016,288,Member,2021-04-05,461092,133427,327665
102023,289,Member,2020-10-12,279921,85437,194484
102030,290,Member,2020-09-06,322706,172301,150405
102037,291,Member,2021-08-05,477755,232280,245475
102044,292,Explorer,2021-05-13,628461,459663,168798
102051,293,Explorer,2020-07-21,866691,85668,781023
102058,294,Explorer,2020-06-27,959796,506458,453338
102065,295,Explorer,2021-07-02,727903,372126,355777
102072,296,Explorer,2022-03-16,641951,414039,227912
102079,297,Explorer,2021-07-05,854271,423579,430692
102086,298,Explorer,2021-07-19,719234,209427,509807
102093,299,Member,2021-09-30,277692,11673,266019
102100,300,Explorer,2021-10-14,892277,459140,433137
102107,301,Member,2021-02-06,323028,2238,320790
102114,302,Explorer,2020-11-24,707115,378616,328499
102121,303,Member,2022-06-02,324754,308432,16322
102128,304,Explorer,2021-11-27,864688,826211,38477
102135,305,Member,2021-09-23,377523,10820,366703
102142,306,Member,2021-04-18,201414,16038,185376
102149,307,Explorer,2022-03-27,943466,91893,851573
102156,308,Member,2022-03-21,244828,77861,166967
102163,309,Member,2022-03-25,286822,267771,19051
102170,310,Explorer,2020-08-14,975768,766980,208788
102177,311,Explorer,2020-09-23,957601,770499,187102
102184,312,Member,2021-11-10,229216,132171,97045
102191,313,Explorer,2020-06-09,806095,387721,418374
102198,314,Member,2021-11-28,458007,169627,288380
102205,315,Explorer,2020-08-15,990291,857660,132631
102212,316,Explorer,2022-05-16,605086,462838,142248
102219,317,Explorer,2022-02-04,884007,557957,326050
102226,318,Explorer,2020-08-03,821291,212028,609263
102233,319,Member,2022-04-29,432101,426081,6020
102240,320,Explorer,2020-12-02,965127,645306,319821
102247,321,Member,2021-02-23,174850,170255,4595
102254,322,Explorer,2021-11-11,988881,369461,619420
102261,323,Member,2021-03-15,375387,319388,55999
102268,324,Member,2021-05-28,435940,331768,104172
102275,325,Member,2021-08-30,291181,29336,261845
102282,326,Member,2020-12-13,293722,158175,135547
102289,327,Explorer,2022-04-10,889495,644116,245379
102296,328,Explorer,2020-07-12,834126,540856,293270
102303,329,Member,2020-09-02,374512,345462,29050
102310,330,Explorer,2021-06-19,766618,708340,58278
102317,331,Explorer,2021-05-22,874865,628958,245907
102324,332,Member,2021-08-29,338680,54449,284231
102331,333,Member,2022-01-09,281000,206369,74631
102338,334,Member,2020-06-29,275177,377,274800
102345,335,Explorer,2022-03-30,977216,435079,542137
102352,336,Explorer,2020-10-04,794697,685960,108737
102359,337,Explorer,2021-04-22,996042,763882,232160
102366,338,Member,2020-09-19,110758,108010,2748
102373,339,Member,2022-02-07,153125,73961,79164
102380,340,Explorer,2021-08-16,833290,717431,115859
102387,341,Member,2021-10-02,234755,192375,42380
102394,342,Member,2021-04-12,420013,50842,369171
102401,343,Member,2021-12-04,366525,3895,362630
102408,344,Member,2021-10-12,269659,264107,5552
102415,345,Member,2021-03-04,271514,115387,156127
102422,346,Explorer,2021-06-15,951002,596771,354231
102429,347,Explorer,2020-12-30,622869,271734,351135
102436,348,Explorer,2022-05-13,921127,184216,736911
102443,349,Member,2021-07-08,177804,78388,99416
102450,350,Explorer,2022-03-11,640854,493723,147131
102457,351,Member,2021-06-18,468361,186863,281498
102464,352,Member,2021-01-29,189249,185081,4168
102471,353,Explorer,2020-07-20,717033,440924,276109
102478,354,Explorer,2021-04-16,711091,223680,487411
102485,355,Explorer,2021-07-28,630682,170036,460646
102492,356,Member,2021-10-08,103524,88702,14822
102499,357,Explorer,2021-09-07,679597,22619,656978
102506,358,Member,2020-10-26,295025,285793,9232
102513,359,Member,2021-11-12,254112,37993,216119
102520,360,Member,2021-11-21,250358,167834,82524
102527,361,Explorer,2021-09-27,764115,758508,5607
102534,362,Explorer,2020-09-25,723555,710015,13540
102541,363,Explorer,2022-01-28,826543,781800,44743
102548,364,Explorer,2021-08-15,916132,429897,486235
102555,365,Explorer,2021-05-12,951096,351898,599198
102562,366,Explorer,2022-01-03,742667,300644,442023
102569,367,Explorer,2021-04-14,920053,307572,612481
102576,368,Explorer,2022-03-20,922406,709823,212583
102583,369,Member,2021-08-11,112685,10437,102248
102590,370,Member,2022-02-27,448652,105651,343001
102597,371,Member,2021-03-01,256362,45508,210854
102604,372,Explorer,2021-04-28,956125,594883,361242
102611,373,Member,2020-08-09,359515,294666,64849
102618,374,Explorer,2021-05-03,956365,901843,54522
102625,375,Member,2021-06-11,236872,91931,144941
102632,376,Member,2021-05-21,171025,136206,34819
102639,377,Member,2022-04-15,241711,236322,5389
102646,378,Member,2021-01-12,243183,234556,8627
102653,379,Explorer,2021-10-06,923341,359422,563919
102660,380,Member,2020-11-27,308657,147369,161288
102667,381,Member,2022-03-06,358207,270296,87911
102674,382,Member,2021-06-12,428353,193368,234985
102681,383,Member,2021-06-03,464676,267364,197312
102688,384,Explorer,2021-04-05,683113,596456,86657
102695,385,Member,2020-11-27,166545,160689,5856
102702,386,Member,2022-01-28,366412,130182,236230
102709,387,Member,2021-03-21,227954,102012,125942
102716,388,Explorer,2021-04-19,674023,456622,217401
102723,389,Explorer,2020-09-06,840186,773988,66198
102730,390,Explorer,2021-04-04,842888,218923,623965
102737,391,Member,2022-02-18,103279,59556,43723
102744,392,Explorer,2021-12-15,911856,604586,307270
102751,393,Member,2022-01-29,465219,92917,372302
102758,394,Explorer,2021-09-23,850349,675933,174416
102765,395,Explorer,2020-06-13,877522,128962,748560
102772,396,Explorer,2021-09-30,668226,432584,235642
102779,397,Explorer,2021-08-03,625553,453805,171748
102786,398,Member,2022-02-23,496215,36151,460064
102793,399,Member,2021-01-23,148016,104096,43920
102800,400,Explorer,2022-03-02,999840,395893,603947
102807,401,Member,2021-04-07,166044,99204,66840
102814,402,Explorer,2022-02-06,835607,305233,530374
102821,403,Explorer,2021-08-01,659406,476335,183071
102828,404,Member,2021-04-14,118420,92865,25555
102835,405,Member,2021-06-28,144971,142597,2374
102842,406,Member,2021-07-08,287113,111591,175522
102849,407,Explorer,2021-09-04,756923,382248,374675
102856,408,Member,2021-10-27,423750,303265,120485
102863,409,Member,2020-10-18,175827,76490,99337
102870,410,Explorer,2022-04-09,776471,118238,658233
102877,411,Explorer,2020-08-01,659281,259414,399867
102884,412,Explorer,2020-12-15,947110,716850,230260
102891,413,Explorer,2022-03-16,701892,491054,210838
102898,414,Explorer,2022-02-11,645654,122922,522732
102905,415,Member,2021-08-17,270051,265414,4637
102912,416,Member,2020-08-19,162655,9759,152896
102919,417,Member,2021-02-10,437970,120741,317229
102926,418,Member,2020-09-25,470844,99670,371174
102933,419,Explorer,2021-10-30,788002,376204,411798
102940,420,Member,2021-11-23,372312,89472,282840
102947,421,Member,2021-03-21,364234,119197,245037
102954,422,Member,2020-08-09,176574,47747,128827
102961,423,Explorer,2020-07-31,911130,232548,678582
102968,424,Member,2021-07-26,419416,124178,295238
102975,425,Explorer,2022-04-11,939467,454281,485186
102982,426,Member,2021-03-12,260861,222,260639
102989,427,Member,2021-09-16,321855,198244,123611
102996,428,Member,2021-06-20,302551,96846,205705
103003,429,Member,2020-10-10,401265,337376,63889
103010,430,Member,2022-03-30,463189,75033,388156
103017,431,Member,2021-10-11,323554,304877,18677
103024,432,Explorer,2022-02-23,727898,473205,254693
103031,433,Explorer,2021-06-25,939411,886565,52846
103038,434,Explorer,2020-12-30,691422,324288,367134
103045,435,Explorer,2020-12-31,967932,114175,853757
103052,436,Member,2021-07-06,385463,236528,148935
103059,437,Member,2021-12-06,389077,119233,269844
103066,438,Member,2021-08-16,353130,320670,32460
103073,439,Explorer,2022-04-15,686455,519727,166728
103080,440,Member,2021-04-30,324276,9193,315083
103087,441,Explorer,2022-03-23,782396,580270,202126
103094,442,Member,2021-11-30,428937,51480,377457
103101,443,Member,2020-07-07,302398,58651,243747
103108,444,Member,2020-11-28,432235,120255,311980
103115,445,Member,2021-08-12,173594,107583,66011
103122,446,Explorer,2021-02-26,843499,618919,224580
103129,447,Explorer,2022-03-15,778097,566017,212080
103136,448,Member,2022-01-24,222792,16150,206642
103143,449,Member,2022-04-01,197397,140586,56811
103150,450,Member,2020-09-22,318039,153988,164051
103157,451,Explorer,2022-06-03,773106,209697,563409
103164,452,Explorer,2022-01-14,838759,813934,24825
103171,453,Member,2020-12-05,105246,96546,8700
103178,454,Member,2021-08-30,476078,139435,336643
103185,455,Member,2022-06-02,463859,173322,290537
103192,456,Explorer,2020-07-26,912514,651432,261082
103199,457,Member,2021-10-11,467549,161503,306046
103206,458,Explorer,2020-11-18,948174,685286,262888
103213,459,Member,2022-03-30,178456,116573,61883
103220,460,Explorer,2020-07-05,631015,556061,74954
103227,461,Explorer,2021-06-22,792751,489342,303409
103234,462,Explorer,2021-11-11,771789,529373,242416
103241,463,Explorer,2022-02-15,713112,175245,537867
103248,464,Member,2021-12-02,290049,101925,188124
103255,465,Member,2020-06-26,307405,10954,296451
103262,466,Explorer,2022-05-07,753910,455105,298805
103269,467,Explorer,2021-01-22,995384,579856,415528
103276,468,Member,2021-04-07,385986,212974,173012
103283,469,Explorer,2020-10-02,932934,4747,928187
103290,470,Member,2020-08-02,116920,83592,33328
103297,471,Explorer,2021-02-09,921038,370957,550081
103304,472,Explorer,2021-08-28,998462,20637,977825
103311,473,Explorer,2020-09-11,818289,340044,478245
103318,474,Explorer,2021-02-15,961183,259257,701926
103325,475,Explorer,2021-02-09,700709,682325,18384
103332,476,Explorer,2022-04-15,826529,687902,138627
103339,477,Member,2021-05-30,284460,199081,85379
103346,478,Explorer,2021-11-09,899914,409900,490014
103353,479,Explorer,2021-11-18,719041,412451,306590
103360,480,Member,2021-02-01,234973,97149,137824
103367,481,Explorer,2021-06-25,752625,639287,113338
103374,482,Explorer,2021-08-04,949332,414737,534595
103381,483,Member,2020-10-01,469565,105461,364104
103388,484,Explorer,2020-08-31,784365,206113,578252
103395,485,Explorer,2022-03-25,847963,16171,831792
103402,486,Explorer,2020-06-20,983650,397534,586116
103409,487,Member,2022-02-24,132015,83268,48747
103416,488,Member,2021-08-15,280383,223289,57094
103423,489,Explorer,2020-11-10,895199,779160,116039
103430,490,Explorer,2021-03-11,827903,163138,664765
103437,491,Member,2022-06-07,278024,241983,36041
103444,492,Member,2021-01-05,163771,135583,28188
103451,493,Member,2021-07-26,393154,277615,115539
103458,494,Explorer,2020-12-11,802737,758838,43899
103465,495,Explorer,2021-08-19,690156,387889,302267
103472,496,Member,2022-02-17,233523,93751,139772
103479,497,Explorer,2022-05-19,623345,555658,67687
103486,498,Member,2021-08-28,444843,282089,162754
103493,499,Member,2020-08-26,133685,56681,77004
103500,500,Explorer,2022-02-03,850670,817268,33402
103507,501,Member,2021-03-30,492326,37321,455005
103514,502,Member,2022-04-09,428882,175757,253125
103521,503,Explorer,2020-09-21,649609,87394,562215
103528,504,Member,2020-09-23,416792,17506,399286
103535,505,Explorer,2021-05-13,607789,601317,6472
103542,506,Explorer,2021-09-26,604892,417729,187163
103549,507,Member,2021-08-06,116849,70329,46520
103556,508,Member,2021-06-07,405571,171850,233721
103563,509,Member,2021-08-27,129917,59082,70835
103570,510,Explorer,2020-06-12,606058,500646,105412
103577,511,Member,2022-02-24,246401,36956,209445
103584,512,Member,2021-10-09,127538,97427,30111
103591,513,Explorer,2021-05-11,922454,594851,327603
103598,514,Explorer,2020-08-04,747466,45157,702309
103605,515,Member,2020-06-16,344671,280892,63779
103612,516,Member,2021-12-23,116523,39981,76542
103619,517,Member,2021-09-23,454376,302785,151591
103626,518,Explorer,2021-04-12,697474,296862,400612
103633,519,Explorer,2021-12-25,887699,118946,768753
103640,520,Member,2020-12-08,475945,428136,47809
103647,521,Explorer,2021-08-30,930070,572481,357589
103654,522,Member,2021-08-13,141229,53496,87733
103661,523,Explorer,2021-05-28,634153,47251,586902
103668,524,Member,2022-05-22,207529,115642,91887
103675,525,Member,2022-04-26,434409,222974,211435
103682,526,Explorer,2022-03-17,677593,168166,509427
103689,527,Explorer,2020-12-03,682066,290283,391783
103696,528,Explorer,2022-05-29,645975,139924,506051
103703,529,Member,2020-07-11,216896,99361,117535
103710,530,Member,2022-02-10,274439,72965,201474
103717,531,Explorer,2022-01-27,783011,14586,768425
103724,532,Member,2021-09-27,376867,307212,69655
103731,533,Explorer,2022-04-26,996135,25597,970538
103738,534,Member,2020-12-28,407665,273936,133729
103745,535,Member,2021-04-08,478706,103494,375212
103752,536,Explorer,2020-08-29,739214,355686,383528
103759,537,Member,2021-07-31,362052,72539,289513
103766,538,Member,2020-10-23,497455,397127,100328
103773,539,Member,2021-04-30,313829,121078,192751
103780,540,Explorer,2021-06-24,725451,537077,188374
103787,541,Member,2020-12-20,397881,187297,210584
103794,542,Member,2022-02-05,351751,153437,198314
103801,543,Explorer,2020-10-15,961294,933739,27555
103808,544,Explorer,2021-09-23,660110,49645,610465
103815,545,Explorer,2021-11-22,949991,527778,422213
103822,546,Explorer,2020-10-11,864693,424482,440211
103829,547,Member,2021-03-01,372518,298580,73938
103836,548,Explorer,2021-11-11,990746,846775,143971
103843,549,Explorer,2022-02-08,842033,700398,141635
103850,550,Member,2020-10-02,417185,301989,115196
103857,551,Member,2020-06-16,190984,152879,38105
103864,552,Explorer,2021-07-19,919418,900594,18824
103871,553,Explorer,2021-02-23,654055,406653,247402
103878,554,Explorer,2020-11-27,947509,836394,111115
103885,555,Explorer,2021-10-14,954320,419962,534358
103892,556,Explorer,2022-03-09,919775,459613,460162
103899,557,Explorer,2021-07-31,869748,25625,844123
103906,558,Member,2020-12-03,193134,55846,137288
103913,559,Member,2021-07-08,424717,154011,270706
103920,560,Explorer,2020-11-05,769763,390546,379217
103927,561,Explorer,2021-12-08,737822,699842,37980
103934,562,Member,2021-07-19,444283,417233,27050
103941,563,Explorer,2021-01-21,874492,671736,202756
103948,564,Explorer,2021-11-10,926764,783262,143502
103955,565,Explorer,2021-11-17,709690,164218,545472
103962,566,Member,2021-01-03,209995,169531,40464
103969,567,Member,2022-03-04,298576,114145,184431
103976,568,Explorer,2022-01-10,799104,776552,22552
103983,569,Explorer,2021-02-13,636760,467374,169386
103990,570,Member,2020-09-21,438244,302485,135759
103997,571,Member,2021-10-11,250311,227005,23306
104004,572,Explorer,2021-08-15,837538,209136,628402
104011,573,Member,2021-05-03,472846,403737,69109
104018,574,Member,2021-08-03,318124,240785,77339
104025,575,Member,2020-12-18,130106,7990,122116
104032,576,Member,2021-03-19,376949,159813,217136
104039,577,Member,2020-07-21,204538,143159,61379
104046,578,Member,2021-12-10,327114,282197,44917
104053,579,Explorer,2021-11-29,801451,95050,706401
104060,580,Explorer,2021-04-06,842471,353006,489465
104067,581,Member,2021-06-18,235072,134744,100328
104074,582,Member,2022-05-11,280760,278139,2621
104081,583,Member,2022-04-23,495386,314406,180980
104088,584,Explorer,2021-05-28,975396,924982,50414
104095,585,Explorer,2020-12-12,759720,293970,465750
104102,586,Explorer,2021-05-09,939077,75829,863248
104109,587,Explorer,2022-02-05,875044,406082,468962
104116,588,Explorer,2021-02-23,856259,572211,284048
104123,589,Explorer,2021-12-19,699276,54648,644628
104130,590,Explorer,2021-09-15,855840,283457,572383
104137,591,Member,2021-05-26,494990,66143,428847
104144,592,Explorer,2020-11-01,964037,311315,652722
104151,593,Member,2021-04-28,191377,140423,50954
104158,594,Member,2021-01-30,466752,227271,239481
104165,595,Explorer,2020-12-14,669465,111479,557986
104172,596,Explorer,2022-03-11,733610,610616,122994
104179,597,Member,2020-12-11,491408,31360,460048
104186,598,Member,2020-11-17,271060,31161,239899
104193,599,Member,2021-03-07,365677,40010,325667
104200,600,Member,2020-11-23,250739,146251,104488
104207,601,Member,2021-12-09,133172,5519,127653
104214,602,Member,2021-10-11,284239,78815,205424
104221,603,Explorer,2021-11-18,834286,593106,241180
104228,604,Explorer,2020-11-06,923319,637083,286236
104235,605,Explorer,2020-11-03,760670,646312,114358
104242,606,Explorer,2021-01-02,896153,611989,284164
104249,607,Member,2021-03-01,405244,208159,197085
104256,608,Explorer,2021-09-22,651662,245111,406551
104263,609,Member,2021-12-04,361780,166946,194834
104270,610,Member,2020-08-12,276170,187961,88209
104277,611,Explorer,2021-05-14,675794,254969,420825
104284,612,Member,2022-05-23,421918,274047,147871
104291,613,Member,2021-02-14,279553,219473,60080
104298,614,Explorer,2021-07-04,949665,604477,345188
104305,615,Member,2020-08-03,482321,29521,452800
104312,616,Member,2020-10-18,329616,94685,234931
104319,617,Member,2022-05-01,490787,324979,165808
104326,618,Member,2020-11-13,463311,82202,381109
104333,619,Explorer,2021-05-11,935177,612204,322973
104340,620,Member,2021-03-13,434243,346080,88163
104347,621,Explorer,2021-09-06,895980,411759,484221
104354,622,Explorer,2020-08-03,833669,590814,242855
104361,623,Explorer,2021-04-25,653175,354422,298753
104368,624,Member,2021-02-17,214805,11016,203789
104375,625,Member,2020-11-07,421492,33485,388007
104382,626,Explorer,2021-10-02,934442,624354,310088
104389,627,Member,2021-10-21,396100,135610,260490
104396,628,Member,2021-03-02,275449,44563,230886
104403,629,Explorer,2021-11-05,767383,594394,172989
104410,630,Member,2021-01-29,455129,355542,99587
104417,631,Member,2021-05-18,407592,376985,30607
104424,632,Member,2022-01-04,257887,194579,63308
104431,633,Explorer,2021-05-26,709412,453811,255601
104438,634,Explorer,2020-07-12,883858,300594,583264
104445,635,Explorer,2021-07-16,694561,344568,349993
104452,636,Explorer,2021-08-07,646448,16972,629476
104459,637,Explorer,2020-07-02,903411,715234,188177
104466,638,Explorer,2020-10-03,812095,365383,446712
104473,639,Member,2020-10-20,126036,96899,29137
104480,640,Member,2021-12-23,351919,251999,99920
104487,641,Member,2022-03-02,398605,95420,303185
104494,642,Explorer,2021-08-19,646895,438311,208584
104501,643,Explorer,2020-06-16,631006,211327,419679
104508,644,Member,2022-01-29,204389,66561,137828
104515,645,Member,2020-10-02,201510,76741,124769
104522,646,Member,2021-03-30,291543,233676,57867
104529,647,Explorer,2022-04-23,661990,384847,277143
104536,648,Explorer,2020-10-02,826485,540515,285970
104543,649,Explorer,2021-02-04,890329,879159,11170
104550,650,Member,2020-07-30,450241,146565,303676
104557,651,Explorer,2021-09-18,938666,390532,548134
104564,652,Explorer,2021-06-30,990639,261525,729114
104571,653,Explorer,2020-10-26,922456,753493,168963
104578,654,Member,2021-08-28,405098,11984,393114
104585,655,Member,2021-12-13,128532,31717,96815
104592,656,Explorer,2021-09-10,670054,572881,97173
104599,657,Member,2022-04-18,138154,54482,83672
104606,658,Member,2021-10-22,277168,178105,99063
104613,659,Member,2020-08-14,482175,322202,159973
104620,660,Member,2021-02-12,180145,175892,4253
104627,661,Member,2020-06-13,297096,99399,197697
104634,662,Explorer,2020-08-19,741769,439276,302493
104641,663,Member,2022-01-13,390576,194157,196419
104648,664,Explorer,2021-08-06,904132,470213,433919
104655,665,Explorer,2021-01-05,604283,471730,132553
104662,666,Member,2020-06-20,110223,96460,13763
104669,667,Explorer,2021-10-14,959620,497364,462256
104676,668,Member,2021-08-23,361520,241679,119841
104683,669,Explorer,2022-01-15,677295,612834,64461
104690,670,Member,2020-08-08,491457,322933,168524
104697,671,Explorer,2020-08-19,823950,762011,61939
104704,672,Member,2021-11-01,221094,79813,141281
104711,673,Explorer,2020-07-10,859447,410285,449162
104718,674,Explorer,2020-09-12,621379,560241,61138
104725,675,Explorer,2020-11-29,671800,611824,59976
104732,676,Explorer,2020-12-20,984564,694785,289779
104739,677,Explorer,2021-08-25,846386,386519,459867
104746,678,Explorer,2022-04-29,831727,541625,290102
104753,679,Member,2021-01-15,419859,339665,80194
104760,680,Member,2021-12-25,125712,98430,27282
104767,681,Explorer,2021-03-30,753899,613178,140721
104774,682,Explorer,2021-04-01,918425,645303,273122
104781,683,Member,2022-05-08,121826,23012,98814
104788,684,Explorer,2020-11-21,829999,703673,126326
104795,685,Member,2022-01-07,248016,161749,86267
104802,686,Member,2020-12-02,174759,105416,69343
104809,687,Explorer,2022-06-05,857148,756964,100184
104816,688,Member,2021-04-08,187324,83640,103684
104823,689,Explorer,2021-08-19,973311,589994,383317
104830,690,Explorer,2021-07-31,711680,647155,64525
104837,691,Member,2021-11-08,481983,452923,29060
104844,692,Member,2022-02-01,160095,144860,15235
104851,693,Explorer,2021-12-16,657682,408089,249593
104858,694,Explorer,2021-06-11,744795,156645,588150
104865,695,Explorer,2022-02-27,625437,46103,579334
104872,696,Member,2022-05-24,123661,70695,52966
104879,697,Member,2022-02-21,386745,6423,380322
104886,698,Explorer,2020-12-23,920967,53534,867433
104893,699,Member,2020-11-04,303366,262759,40607
104900,700,Explorer,2022-01-08,863394,344482,518912
104907,701,Member,2022-03-15,313948,71414,242534
104914,702,Member,2020-08-08,132919,64157,68762
104921,703,Member,2020-10-06,119917,40280,79637
104928,704,Member,2021-12-01,416499,198809,217690
104935,705,Explorer,2021-08-25,992868,621677,371191
104942,706,Explorer,2021-06-03,660758,586530,74228
104949,707,Member,2021-07-29,164824,146716,18108
104956,708,Member,2020-11-11,316173,237985,78188
104963,709,Explorer,2021-07-24,860156,557702,302454
104970,710,Member,2020-10-31,383751,56796,326955
104977,711,Explorer,2021-04-04,707269,370684,336585
104984,712,Explorer,2021-08-18,725384,34488,690896
104991,713,Explorer,2021-06-26,934073,27769,906304
104998,714,Member,2022-02-03,347990,303661,44329
105005,715,Explorer,2021-01-16,682215,232345,449870
105012,716,Member,2021-05-22,135674,71654,64020
105019,717,Member,2021-03-01,265218,238952,26266
105026,718,Member,2021-04-02,352675,281925,70750
105033,719,Member,2022-01-27,378430,355754,22676
105040,720,Member,2021-12-16,430211,287132,143079
105047,721,Explorer,2021-08-10,942582,134534,808048
105054,722,Member,2021-05-06,342438,240175,102263
105061,723,Member,2021-06-15,494044,455030,39014
105068,724,Explorer,2022-02-18,898853,508218,390635
105075,725,Member,2022-02-15,479486,327262,152224
105082,726,Member,2020-08-22,249107,127793,121314
105089,727,Member,2021-02-17,169109,143279,25830
105096,728,Explorer,2022-05-25,842668,177083,665585
105103,729,Explorer,2020-10-17,784964,231288,553676
105110,730,Member,2021-02-11,227083,91218,135865
105117,731,Explorer,2022-03-30,897719,661168,236551
105124,732,Explorer,2022-01-26,771388,256225,515163
105131,733,Member,2021-05-31,277020,114344,162676
105138,734,Member,2021-10-21,406825,154670,252155
105145,735,Explorer,2020-08-13,963953,730967,232986
105152,736,Member,2022-05-29,306066,113506,192560
105159,737,Member,2022-06-02,433548,5428,428120
105166,738,Explorer,2022-06-04,971356,386111,585245
105173,739,Member,2021-06-14,383614,362747,20867
105180,740,Member,2020-09-15,412429,384156,28273
105187,741,Member,2021-11-26,437764,280250,157514
105194,742,Member,2020-10-04,190548,175273,15275
105201,743,Explorer,2021-11-27,933593,541287,392306
105208,744,Explorer,2020-10-13,820502,590618,229884
105215,745,Explorer,2020-11-14,889448,388063,501385
105222,746,Member,2020-09-27,265783,57439,208344
105229,747,Explorer,2022-05-12,724904,137943,586961
105236,748,Member,2020-12-09,306248,250354,55894
105243,749,Explorer,2022-01-05,751272,130841,620431
105250,750,Member,2022-03-17,345755,295900,49855
105257,751,Explorer,2022-06-01,748312,256878,491434
105264,752,Explorer,2022-04-02,716499,396214,320285
105271,753,Member,2021-12-15,431480,373675,57805
105278,754,Explorer,2022-04-23,797252,455038,342214
105285,755,Explorer,2020-11-29,931539,850199,81340
105292,756,Member,2021-09-29,194426,160344,34082
105299,757,Explorer,2021-05-19,896932,621819,275113
105306,758,Explorer,2021-11-06,852218,334252,517966
105313,759,Explorer,2021-11-22,725857,114881,610976
105320,760,Member,2022-04-12,393769,73658,320111
105327,761,Member,2022-04-02,199545,58927,140618
105334,762,Explorer,2022-02-28,924048,149927,774121
105341,763,Member,2022-03-14,223536,18156,205380
105348,764,Member,2021-05-29,493949,216993,276956
105355,765,Explorer,2022-05-17,773716,715042,58674
105362,766,Member,2020-09-04,365015,170133,194882
105369,767,Explorer,2022-03-23,935954,779368,156586
105376,768,Member,2021-01-23,315172,190787,124385
105383,769,Explorer,2021-12-03,743361,555319,188042
105390,770,Explorer,2021-06-11,817532,297413,520119
105397,771,Member,2020-06-25,217026,49199,167827
105404,772,Explorer,2021-05-12,802442,254607,547835
105411,773,Member,2020-12-07,427852,15924,411928
105418,774,Member,2022-01-06,471397,395914,75483
105425,775,Member,2021-11-02,145226,48318,96908
105432,776,Member,2021-11-30,218926,24413,194513
105439,777,Explorer,2020-11-19,974795,222499,752296
105446,778,Member,2020-11-21,329548,273951,55597
105453,779,Explorer,2022-03-25,994063,676432,317631
105460,780,Member,2021-08-01,247805,38162,209643
105467,781,Member,2021-01-20,184795,97921,86874
105474,782,Explorer,2021-05-16,975616,436431,539185
105481,783,Explorer,2020-12-02,699507,375525,323982
105488,784,Explorer,2021-02-20,637376,134572,502804
105495,785,Member,2021-02-21,411685,156091,255594
105502,786,Explorer,2021-05-08,743065,382605,360460
105509,787,Member,2022-03-24,190554,30465,160089
105516,788,Explorer,2020-10-20,613591,108058,505533
105523,789,Explorer,2022-04-21,699757,1184,698573
105530,790,Explorer,2021-07-18,638148,254817,383331
105537,791,Member,2020-06-12,172116,121745,50371
105544,792,Explorer,2020-10-27,898551,305264,593287
105551,793,Member,2020-07-30,396748,245864,150884
105558,794,Member,2021-05-08,377688,333824,43864
105565,795,Member,2022-01-17,324383,200291,124092
105572,796,Explorer,2021-05-28,978559,552512,426047
105579,797,Explorer,2020-12-13,840639,329723,510916
105586,798,Explorer,2021-07-25,846585,648428,198157
105593,799,Member,2021-06-01,206877,151176,55701
105600,800,Member,2020-10-16,355066,188090,166976
105607,801,Explorer,2020-08-04,627173,338866,288307
105614,802,Explorer,2021-08-11,649739,120818,528921
105621,803,Explorer,2020-09-15,978971,342663,636308
105628,804,Member,2020-12-05,468030,271375,196655
105635,805,Member,2022-02-23,356470,87468,269002
105642,806,Member,2021-01-16,178626,176034,2592
105649,807,Explorer,2020-11-28,871326,399742,471584
105656,808,Explorer,2020-07-20,802901,405504,397397
105663,809,Member,2022-06-06,353313,12163,341150
105670,810,Member,2021-03-06,316480,197466,119014
105677,811,Member,2022-05-11,445582,236085,209497
105684,812,Member,2020-07-17,181255,29488,151767
105691,813,Member,2021-03-04,415030,413974,1056
105698,814,Explorer,2020-11-05,794528,17471,777057
105705,815,Explorer,2021-04-06,709759,387223,322536
105712,816,Member,2021-05-19,106035,87560,18475
105719,817,Explorer,2021-10-24,852630,121633,730997
105726,818,Explorer,2021-10-20,941652,438904,502748
105733,819,Member,2020-12-07,246779,34650,212129
105740,820,Member,2021-08-16,101230,94276,6954
105747,821,Explorer,2020-11-22,835843,562727,273116
105754,822,Member,2021-10-24,192757,3716,189041
105761,823,Explorer,2021-08-10,952684,483081,469603
105768,824,Explorer,2022-02-27,832254,205323,626931
105775,825,Member,2022-01-09,496820,169904,326916
105782,826,Member,2022-04-15,175030,91713,83317
105789,827,Member,2021-12-03,396735,319920,76815
105796,828,Explorer,2020-06-19,881560,542364,339196
105803,829,Member,2021-01-10,406758,208753,198005
105810,830,Explorer,2021-04-27,676267,439194,237073
105817,831,Explorer,2022-03-26,970714,14629,956085
105824,832,Member,2020-11-18,265140,233849,31291
105831,833,Member,2022-03-17,228203,78565,149638
105838,834,Member,2022-04-30,415745,249584,166161
105845,835,Member,2021-05-13,399221,366960,32261
105852,836,Explorer,2022-02-05,992056,483007,509049
105859,837,Member,2020-10-21,366930,84672,282258
105866,838,Explorer,2022-04-11,704998,41713,663285
105873,839,Member,2020-10-18,127577,74989,52588
105880,840,Member,2022-03-13,167328,57389,109939
105887,841,Member,2020-12-27,242042,22625,219417
105894,842,Explorer,2022-04-06,846301,420234,426067
105901,843,Member,2020-08-17,265310,68247,197063
105908,844,Explorer,2022-04-06,855974,470496,385478
105915,845,Explorer,2021-12-03,871937,486431,385506
105922,846,Explorer,2020-08-07,639483,255132,384351
105929,847,Member,2020-11-27,258743,216325,42418
105936,848,Explorer,2021-11-16,964816,947930,16886
105943,849,Member,2020-10-20,100750,95,100655
105950,850,Member,2021-07-11,417516,36925,380591
105957,851,Member,2021-07-07,368531,12566,355965
105964,852,Member,2020-09-24,439670,298304,141366
105971,853,Member,2021-08-08,171952,70555,101397
105978,854,Member,2020-11-20,405568,376424,29144
105985,855,Member,2020-10-19,244648,50682,193966
105992,856,Explorer,2020-07-06,867310,570024,297286
105999,857,Explorer,2021-11-30,653214,592194,61020
106006,858,Explorer,2021-10-22,715625,173433,542192
106013,859,Explorer,2020-07-13,863701,589745,273956
106020,860,Member,2021-09-24,237698,152475,85223
106027,861,Explorer,2020-09-25,609806,405740,204066
106034,862,Member,2021-12-07,392777,239153,153624
106041,863,Member,2020-10-03,391111,58903,332208
106048,864,Member,2022-03-06,176588,77612,98976
106055,865,Member,2021-06-22,102463,19846,82617
106062,866,Member,2020-07-04,387746,118053,269693
106069,867,Explorer,2020-07-16,620922,491584,129338
106076,868,Member,2021-02-17,212438,174700,37738
106083,869,Member,2021-05-03,182351,27185,155166
106090,870,Explorer,2021-11-17,871092,728292,142800
106097,871,Member,2020-08-19,339476,16770,322706
106104,872,Explorer,2021-06-13,997620,69328,928292
106111,873,Explorer,2020-12-05,713553,314050,399503
106118,874,Explorer,2022-02-07,881046,431018,450028
106125,875,Member,2021-01-10,130932,123383,7549
106132,876,Member,2022-01-13,162042,10731,151311
106139,877,Member,2021-02-14,160917,56514,104403
106146,878,Explorer,2021-08-05,726344,112332,614012
106153,879,Explorer,2022-01-05,719567,452027,267540
106160,880,Member,2022-04-07,245452,161496,83956
106167,881,Member,2021-12-30,293218,886,292332
106174,882,Explorer,2022-03-21,778146,403889,374257
106181,883,Explorer,2021-10-02,904155,770558,133597
106188,884,Explorer,2022-05-25,943120,782577,160543
106195,885,Member,2022-01-02,313760,183124,130636
106202,886,Explorer,2021-02-11,956496,656539,299957
106209,887,Member,2021-06-24,220299,169203,51096
106216,888,Explorer,2022-04-17,738619,557541,181078
106223,889,Member,2021-11-17,359501,305471,54030
106230,890,Explorer,2021-07-21,702648,557724,144924
106237,891,Explorer,2020-07-11,916114,539515,376599
106244,892,Explorer,2020-11-15,640556,618897,21659
106251,893,Member,2021-01-06,385075,239885,145190
106258,894,Member,2020-10-05,425858,48186,377672
106265,895,Member,2022-02-03,482155,258266,223889
106272,896,Member,2021-11-06,379875,180466,199409
106279,897,Member,2020-11-26,147462,25001,122461
106286,898,Member,2021-05-14,212355,107005,105350
106293,899,Explorer,2021-06-26,936170,200650,735520
106300,900,Member,2020-06-29,262279,31813,230466
106307,901,Explorer,2021-02-22,943870,83015,860855
106314,902,Member,2020-07-15,243271,182930,60341
106321,903,Explorer,2021-04-07,838108,73573,764535
106328,904,Member,2020-06-15,234518,105626,128892
106335,905,Member,2020-08-17,398054,72047,326007
106342,906,Explorer,2020-09-26,860316,620271,240045
106349,907,Member,2021-04-18,418163,184980,233183
106356,908,Member,2021-05-10,273138,980,272158
106363,909,Explorer,2022-02-22,930801,388868,541933
106370,910,Explorer,2021-03-28,825624,90943,734681
106377,911,Member,2021-05-01,276598,118662,157936
106384,912,Explorer,2020-09-11,870259,86586,783673
106391,913,Member,2021-12-16,429110,322212,106898
106398,914,Explorer,2021-04-06,831504,696145,135359
106405,915,Explorer,2021-01-05,623539,121067,502472
106412,916,Explorer,2021-06-05,750909,477028,273881
106419,917,Member,2020-11-22,328343,90255,238088
106426,918,Explorer,2020-10-11,755574,234534,521040
106433,919,Explorer,2021-07-29,918239,105445,812794
106440,920,Explorer,2020-10-26,754819,429973,324846
106447,921,Explorer,2022-03-01,705575,392253,313322
106454,922,Explorer,2021-10-22,698395,137380,561015
106461,923,Member,2020-12-25,439369,144882,294487
106468,924,Member,2022-03-23,305721,58373,247348
106475,925,Explorer,2020-07-25,725367,194932,530435
106482,926,Member,2021-04-08,128276,82828,45448
106489,927,Member,2021-11-12,420093,98287,321806
106496,928,Member,2021-11-01,372064,50396,321668
106503,929,Member,2020-11-22,497557,393029,104528
106510,930,Member,2022-01-03,297736,182062,115674
106517,931,Member,2021-11-26,199688,60959,138729
106524,932,Explorer,2020-06-23,868910,443673,425237
106531,933,Member,2021-04-07,341075,164719,176356
106538,934,Member,2020-07-02,244733,47573,197160
106545,935,Member,2022-05-25,281957,230598,51359
106552,936,Member,2022-05-02,119455,109603,9852
106559,937,Member,2020-10-08,190019,143286,46733
106566,938,Member,2021-08-04,183966,45432,138534
106573,939,Member,2022-05-04,400349,286673,113676
106580,940,Explorer,2021-05-06,906521,47129,859392
106587,941,Explorer,2021-06-21,959182,274644,684538
106594,942,Explorer,2021-08-25,930379,291560,638819
106601,943,Explorer,2022-03-31,814460,570062,244398
106608,944,Explorer,2021-10-02,864341,199847,664494
106615,945,Explorer,2020-11-08,871013,767625,103388
106622,946,Member,2022-03-05,340733,11155,329578
106629,947,Member,2021-04-21,355886,131154,224732
106636,948,Member,2022-04-27,217460,47665,169795
106643,949,Member,2021-02-17,116920,101866,15054
106650,950,Member,2021-09-02,417210,325313,91897
106657,951,Member,2022-04-27,457615,48243,409372
106664,952,Member,2020-06-16,373769,189998,183771
106671,953,Explorer,2022-01-30,757667,599202,158465
106678,954,Explorer,2022-03-20,866452,650918,215534
106685,955,Member,2020-07-04,198899,22139,176760
106692,956,Explorer,2020-12-24,763982,102346,661636
106699,957,Member,2020-12-27,416567,190491,226076
106706,958,Explorer,2020-06-24,647437,260026,387411
106713,959,Explorer,2020-09-06,647085,545685,101400
106720,960,Member,2021-01-18,214756,3224,211532
106727,961,Explorer,2021-12-11,734632,375158,359474
106734,962,Member,2020-10-01,298646,77259,221387
106741,963,Explorer,2021-08-18,970071,929007,41064
106748,964,Explorer,2020-07-14,674178,581384,92794
106755,965,Explorer,2020-07-11,908322,127167,781155
106762,966,Member,2021-12-13,413146,307186,105960
106769,967,Explorer,2022-03-06,777108,215514,561594
106776,968,Member,2021-01-09,404765,163381,241384
106783,969,Member,2021-07-29,195712,100510,95202
106790,970,Explorer,2022-05-14,958899,359595,599304
106797,971,Explorer,2021-05-08,619949,185758,434191
106804,972,Member,2021-06-25,195132,31307,163825
106811,973,Explorer,2021-02-08,719132,226952,492180
106818,974,Explorer,2021-12-17,911893,410611,501282
106825,975,Member,2021-02-15,114383,31160,83223
106832,976,Explorer,2020-08-14,907163,610868,296295
106839,977,Explorer,2020-11-04,973069,9816,963253
106846,978,Member,2021-04-01,128979,43032,85947
106853,979,Explorer,2021-04-08,689958,144598,545360
106860,980,Explorer,2020-08-06,675754,515385,160369
106867,981,Explorer,2020-07-09,777958,308196,469762
106874,982,Member,2021-11-26,339720,270271,69449
106881,983,Explorer,2022-03-16,638452,75239,563213
106888,984,Member,2022-03-15,262174,72965,189209
106895,985,Member,2020-11-24,367585,40384,327201
106902,986,Explorer,2022-01-28,654407,383439,270968
106909,987,Member,2020-07-27,209464,46369,163095
106916,988,Explorer,2021-12-09,983995,132091,851904
106923,989,Member,2021-12-03,144092,96188,47904
106930,990,Explorer,2021-06-24,989492,357490,632002
106937,991,Member,2021-05-10,165679,109384,56295
106944,992,Explorer,2020-06-14,719558,355135,364423
106951,993,Explorer,2021-02-15,680221,286094,394127
106958,994,Explorer,2020-09-10,627245,388025,239220
106965,995,Member,2021-07-25,377073,335377,41696
106972,996,Explorer,2022-05-21,967697,792885,174812
106979,997,Member,2021-09-03,385024,164326,220698
106986,998,Explorer,2020-12-02,715112,130777,584335
106993,999,Member,2021-04-13,265957,25204,240753
107000,1000,Explorer,2022-02-22,715746,655280,60466
