profile_id,contact_id,tier,join_date,points_accrued,points_spent,points_balance
100007,1,Member,7/6/2021,396387,27201,369186
100014,2,Member,6/1/2021,408568,55345,353223
100021,3,Explorer,1/8/2021,877001,223058,653943
100028,4,Member,4/3/2021,226253,52346,173907
100035,5,Explorer,2/25/2021,792394,180087,612307
100042,6,Member,9/15/2020,411898,286179,125719
100049,7,Explorer,8/22/2020,650480,488169,162311
100056,8,Explorer,6/5/2021,952394,642244,310150
100063,9,Member,3/30/2021,344134,325304,18830
100070,10,Member,6/14/2021,253964,184820,69144
100077,11,Member,7/4/2020,258612,7122,251490
100084,12,Member,1/8/2022,489515,247760,241755
100091,13,Explorer,6/29/2021,711419,249664,461755
100098,14,Explorer,10/27/2020,751302,129569,621733
100105,15,Member,5/2/2022,323373,10709,312664
100112,16,Explorer,12/16/2021,651669,599974,51695
100119,17,Member,2/16/2022,158988,128530,30458
100126,18,Explorer,5/14/2021,979823,207822,772001
100133,19,Explorer,6/16/2021,765402,670322,95080
100140,20,Member,7/10/2021,135648,135534,114
100147,21,Explorer,4/14/2022,772272,359484,412788
100154,22,Explorer,4/20/2022,632324,112457,519867
100161,23,Member,7/7/2021,157961,82712,75249
100168,24,Explorer,5/6/2021,791726,340522,451204
100175,25,Explorer,4/18/2022,799840,786486,13354
100182,26,Member,6/30/2020,202193,124563,77630
100189,27,Explorer,10/1/2021,786485,89131,697354
100196,28,Explorer,6/8/2021,784023,89820,694203
100203,29,Explorer,5/22/2021,751456,509693,241763
100210,30,Member,3/4/2021,143785,70807,72978
100217,31,Explorer,8/4/2020,783139,528079,255060
100224,32,Explorer,6/13/2021,671121,238081,433040
100231,33,Explorer,6/10/2020,935906,883770,52136
100238,34,Member,4/14/2021,143449,84830,58619
100245,35,Member,10/26/2020,412274,258087,154187
100252,36,Explorer,10/13/2021,963234,514523,448711
100259,37,Member,9/13/2021,227203,44317,182886
100266,38,Explorer,12/20/2021,847551,243321,604230
100273,39,Member,12/20/2020,181481,61830,119651
100280,40,Member,6/3/2021,364704,273423,91281
100287,41,Explorer,11/4/2020,638473,527768,110705
100294,42,Explorer,9/27/2020,952865,693786,259079
100301,43,Member,4/5/2021,138669,112927,25742
100308,44,Member,11/14/2021,185394,18340,167054
100315,45,Explorer,1/23/2021,724979,178517,546462
100322,46,Member,11/6/2020,404352,14312,390040
100329,47,Explorer,7/4/2020,681656,658343,23313
100336,48,Member,5/23/2022,218219,87119,131100
100343,49,Member,1/10/2021,128534,88196,40338
100350,50,Explorer,12/13/2020,881985,535741,346244
100357,51,Explorer,6/9/2020,845304,574869,270435
100364,52,Member,3/19/2022,117920,58704,59216
100371,53,Member,6/6/2021,391935,81664,310271
100378,54,Explorer,4/13/2021,999099,958024,41075
100385,55,Explorer,4/15/2021,645307,494670,150637
100392,56,Explorer,4/19/2021,764144,112188,651956
100399,57,Member,7/7/2020,217901,49402,168499
100406,58,Member,1/31/2022,311125,52404,258721
100413,59,Explorer,10/14/2020,639235,397264,241971
100420,60,Member,4/9/2021,401354,307471,93883
100427,61,Explorer,10/26/2021,616328,194152,422176
100434,62,Explorer,1/5/2021,799366,62058,737308
100441,63,Member,4/24/2022,454352,48799,405553
100448,64,Explorer,9/1/2020,947063,604089,342974
100455,65,Member,12/4/2020,201259,141527,59732
100462,66,Member,3/23/2021,458882,251455,207427
100469,67,Member,5/19/2021,486399,267398,219001
100476,68,Explorer,12/13/2021,623910,320402,303508
100483,69,Explorer,8/25/2021,827225,102698,724527
100490,70,Explorer,12/22/2020,844441,215435,629006
100497,71,Member,10/11/2021,116639,46883,69756
100504,72,Explorer,1/16/2022,842789,727807,114982
100511,73,Member,7/13/2021,440536,308153,132383
100518,74,Explorer,12/2/2021,609697,601660,8037
100525,75,Member,9/14/2021,235634,52741,182893
100532,76,Explorer,8/21/2020,817992,452978,365014
100539,77,Member,3/22/2021,306434,163430,143004
100546,78,Explorer,8/30/2021,976446,128585,847861
100553,79,Explorer,5/7/2021,827844,621928,205916
100560,80,Explorer,4/14/2022,822987,2423,820564
100567,81,Explorer,7/14/2021,859986,488788,371198
100574,82,Explorer,12/3/2020,895605,471018,424587
100581,83,Explorer,6/19/2020,942544,332966,609578
100588,84,Member,9/1/2021,139791,86412,53379
100595,85,Member,1/30/2022,450704,216835,233869
100602,86,Member,2/4/2021,235068,7744,227324
100609,87,Explorer,2/23/2021,749697,176882,572815
100616,88,Explorer,3/9/2022,717637,679516,38121
100623,89,Explorer,8/27/2020,917804,403165,514639
100630,90,Member,6/23/2021,181979,55685,126294
100637,91,Explorer,6/14/2021,957320,89428,867892
100644,92,Explorer,2/8/2022,686466,429584,256882
100651,93,Member,4/11/2022,429583,241868,187715
100658,94,Member,11/23/2021,391384,17996,373388
100665,95,Explorer,5/9/2022,692883,429547,263336
100672,96,Member,8/9/2020,113091,95082,18009
100679,97,Explorer,7/15/2021,759519,128230,631289
100686,98,Explorer,2/14/2021,712415,114506,597909
100693,99,Member,5/23/2021,323923,52568,271355
100700,100,Member,11/10/2021,275458,166128,109330
100707,101,Explorer,11/7/2020,953021,224523,728498
100714,102,Member,6/7/2022,129886,62082,67804
100721,103,Member,8/24/2020,170007,54636,115371
100728,104,Explorer,2/13/2022,845838,401753,444085
100735,105,Explorer,8/18/2020,895665,409049,486616
100742,106,Explorer,10/12/2021,741500,139135,602365
100749,107,Explorer,12/3/2021,730280,491864,238416
100756,108,Member,11/4/2020,334908,136514,198394
100763,109,Explorer,8/12/2021,719343,398605,320738
100770,110,Explorer,7/28/2021,634058,193106,440952
100777,111,Explorer,12/5/2021,925213,833781,91432
100784,112,Member,1/3/2022,195625,148662,46963
100791,113,Member,7/22/2020,341333,53094,288239
100798,114,Member,4/25/2022,167810,148754,19056
100805,115,Member,4/13/2022,414119,131007,283112
100812,116,Explorer,1/18/2021,704911,500523,204388
100819,117,Member,6/28/2020,275969,251048,24921
100826,118,Member,8/27/2021,101840,46206,55634
100833,119,Member,6/6/2021,395830,168262,227568
100840,120,Explorer,6/2/2021,779735,548026,231709
100847,121,Explorer,6/20/2020,785772,167726,618046
100854,122,Explorer,11/4/2020,687741,636135,51606
100861,123,Member,10/18/2020,350452,216621,133831
100868,124,Member,8/27/2020,126980,120482,6498
100875,125,Explorer,11/10/2020,677486,345029,332457
100882,126,Member,11/30/2021,281384,274585,6799
100889,127,Member,11/7/2021,401014,229128,171886
100896,128,Explorer,7/1/2021,696218,623083,73135
100903,129,Explorer,6/27/2020,949193,477409,471784
100910,130,Member,10/10/2021,162551,150622,11929
100917,131,Explorer,9/7/2020,990966,970944,20022
100924,132,Member,10/7/2021,374243,226084,148159
100931,133,Explorer,1/11/2021,676585,97805,578780
100938,134,Member,4/18/2021,430015,342675,87340
100945,135,Member,1/29/2021,478794,189343,289451
100952,136,Member,4/22/2021,248744,194677,54067
100959,137,Explorer,11/29/2021,834348,679393,154955
100966,138,Explorer,9/16/2020,826875,342513,484362
100973,139,Member,12/28/2020,306155,19429,286726
100980,140,Member,12/16/2021,242310,236337,5973
100987,141,Explorer,9/15/2020,726133,33573,692560
100994,142,Member,12/21/2020,407003,83684,323319
101001,143,Member,1/30/2022,302517,128024,174493
101008,144,Explorer,5/30/2021,812355,641490,170865
101015,145,Member,4/21/2021,277842,172096,105746
101022,146,Explorer,3/18/2021,815758,71846,743912
101029,147,Explorer,7/20/2021,844514,366731,477783
101036,148,Explorer,8/21/2020,618665,378539,240126
101043,149,Member,5/20/2021,205569,18719,186850
101050,150,Member,2/20/2022,486149,384122,102027
101057,151,Explorer,1/16/2022,694742,443592,251150
101064,152,Explorer,2/8/2021,840783,265475,575308
101071,153,Explorer,7/3/2021,935452,465012,470440
101078,154,Member,11/20/2021,108079,45521,62558
101085,155,Explorer,3/9/2021,979398,322564,656834
101092,156,Explorer,12/27/2021,868697,482006,386691
101099,157,Explorer,5/20/2021,720708,667236,53472
101106,158,Member,11/29/2021,134365,95604,38761
101113,159,Member,8/3/2021,119579,51396,68183
101120,160,Member,6/9/2021,412805,341420,71385
101127,161,Member,1/21/2022,197486,188677,8809
101134,162,Explorer,7/19/2020,924133,474369,449764
101141,163,Member,6/13/2021,354058,55479,298579
101148,164,Explorer,9/1/2021,769145,620886,148259
101155,165,Member,11/13/2020,458176,669,457507
101162,166,Explorer,8/30/2021,747621,222384,525237
101169,167,Member,10/16/2021,460672,305061,155611
101176,168,Explorer,6/16/2021,659627,655924,3703
101183,169,Member,9/4/2020,386055,2541,383514
101190,170,Explorer,11/2/2021,681544,658139,23405
101197,171,Member,1/26/2022,147056,15175,131881
101204,172,Member,7/22/2020,337417,232977,104440
101211,173,Member,11/27/2021,367474,105519,261955
101218,174,Member,7/21/2021,476031,260006,216025
101225,175,Explorer,5/25/2021,721679,565587,156092
101232,176,Explorer,8/4/2021,775712,103531,672181
101239,177,Member,10/25/2021,166868,121699,45169
101246,178,Explorer,12/20/2020,894407,224168,670239
101253,179,Member,6/19/2020,265457,123808,141649
101260,180,Member,1/21/2021,153361,64984,88377
101267,181,Member,10/24/2020,333395,290316,43079
101274,182,Member,10/1/2020,232244,76086,156158
101281,183,Member,5/11/2022,126638,17063,109575
101288,184,Explorer,3/31/2022,944434,116877,827557
101295,185,Member,12/15/2020,142099,93065,49034
101302,186,Member,10/15/2021,397970,356549,41421
101309,187,Explorer,8/18/2021,849020,35004,814016
101316,188,Explorer,11/12/2020,703605,120053,583552
101323,189,Member,7/6/2020,344513,39215,305298
101330,190,Member,7/24/2020,213025,109547,103478
101337,191,Member,8/19/2021,454168,288931,165237
101344,192,Explorer,5/2/2022,789764,510023,279741
101351,193,Member,2/25/2022,295406,131440,163966
101358,194,Explorer,2/11/2022,722738,363070,359668
101365,195,Explorer,8/5/2020,961846,624043,337803
101372,196,Explorer,1/18/2021,759145,406200,352945
101379,197,Explorer,5/17/2022,755848,509667,246181
101386,198,Explorer,9/1/2021,862201,712495,149706
101393,199,Explorer,11/9/2020,638075,270253,367822
101400,200,Explorer,1/25/2022,960275,543214,417061
101407,201,Explorer,6/17/2021,960784,359632,601152
101414,202,Member,11/14/2021,388512,229651,158861
101421,203,Explorer,11/18/2020,720399,687977,32422
101428,204,Member,12/11/2020,480224,51065,429159
101435,205,Member,3/5/2021,185345,28405,156940
101442,206,Explorer,10/7/2021,896992,882305,14687
101449,207,Member,7/12/2020,278969,51676,227293
101456,208,Explorer,10/15/2021,635795,389613,246182
101463,209,Member,3/19/2021,105192,98324,6868
101470,210,Member,2/13/2022,161798,52890,108908
101477,211,Explorer,5/20/2021,890563,777151,113412
101484,212,Explorer,6/8/2021,921751,484495,437256
101491,213,Explorer,2/12/2021,806311,715819,90492
101498,214,Member,10/27/2020,110459,94203,16256
101505,215,Explorer,4/24/2021,914712,371832,542880
101512,216,Explorer,4/17/2022,648610,430175,218435
101519,217,Explorer,10/23/2021,914813,250163,664650
101526,218,Explorer,8/7/2021,954554,592982,361572
101533,219,Member,5/13/2021,245313,3776,241537
101540,220,Member,11/21/2021,207725,182949,24776
101547,221,Explorer,9/14/2021,925140,425660,499480
101554,222,Member,5/7/2021,310475,280856,29619
101561,223,Member,1/5/2021,120788,93637,27151
101568,224,Explorer,12/18/2020,739689,544366,195323
101575,225,Explorer,3/30/2022,844386,817762,26624
101582,226,Member,8/24/2020,152737,128532,24205
101589,227,Member,1/17/2022,278586,33481,245105
101596,228,Member,10/15/2020,497678,298349,199329
101603,229,Explorer,5/10/2021,960330,939800,20530
101610,230,Member,4/20/2021,128968,43368,85600
101617,231,Explorer,1/31/2022,766689,610057,156632
101624,232,Member,6/6/2021,135102,65635,69467
101631,233,Member,9/23/2020,364181,128662,235519
101638,234,Explorer,12/14/2021,743571,402030,341541
101645,235,Member,10/5/2020,423100,355260,67840
101652,236,Explorer,11/13/2020,619390,405739,213651
101659,237,Explorer,10/11/2021,622159,380734,241425
101666,238,Explorer,8/2/2020,808144,441306,366838
101673,239,Explorer,11/13/2021,614848,281017,333831
101680,240,Member,7/11/2020,275482,43928,231554
101687,241,Member,12/2/2020,453246,168174,285072
101694,242,Explorer,2/11/2021,815491,768262,47229
101701,243,Member,5/7/2022,278636,59716,218920
101708,244,Explorer,5/26/2022,818450,409886,408564
101715,245,Member,6/30/2020,368199,29108,339091
101722,246,Member,6/5/2021,308827,200145,108682
101729,247,Explorer,1/21/2022,816133,329194,486939
101736,248,Explorer,10/21/2020,843977,169042,674935
101743,249,Member,11/2/2021,425033,224296,200737
101750,250,Member,3/8/2022,410031,363845,46186
101757,251,Member,10/31/2020,108443,26426,82017
101764,252,Explorer,4/30/2022,864086,664733,199353
101771,253,Explorer,8/17/2020,981129,432805,548324
101778,254,Member,8/31/2021,244103,36238,207865
101785,255,Explorer,3/1/2021,973856,879971,93885
101792,256,Member,5/20/2022,399461,361037,38424
101799,257,Member,3/13/2022,391511,302734,88777
101806,258,Member,5/4/2021,165239,57223,108016
101813,259,Member,5/4/2021,338587,62800,275787
101820,260,Explorer,9/9/2020,917405,330978,586427
101827,261,Member,1/29/2021,301884,49254,252630
101834,262,Explorer,3/20/2022,964605,578041,386564
101841,263,Explorer,1/9/2022,683867,197296,486571
101848,264,Explorer,11/7/2020,978735,759941,218794
101855,265,Explorer,1/6/2022,652953,530736,122217
101862,266,Member,5/15/2021,186321,125133,61188
101869,267,Member,10/29/2020,130736,111695,19041
101876,268,Member,11/27/2021,477257,242341,234916
101883,269,Explorer,10/18/2020,608021,253627,354394
101890,270,Member,5/13/2022,168940,3493,165447
101897,271,Member,12/3/2021,209416,101537,107879
101904,272,Explorer,4/8/2021,819484,108490,710994
101911,273,Explorer,2/2/2021,969357,675794,293563
101918,274,Explorer,8/9/2020,754510,125239,629271
101925,275,Explorer,7/19/2021,780285,6618,773667
101932,276,Member,4/6/2022,137247,69462,67785
101939,277,Explorer,2/3/2022,604687,311090,293597
101946,278,Member,10/26/2020,263889,39620,224269
101953,279,Explorer,8/1/2021,925262,844616,80646
101960,280,Member,3/24/2021,330703,322613,8090
101967,281,Explorer,6/11/2020,858342,108432,749910
101974,282,Explorer,11/23/2021,766567,504580,261987
101981,283,Explorer,2/3/2022,864512,104248,760264
101988,284,Explorer,4/26/2021,993329,622537,370792
101995,285,Explorer,12/27/2020,725967,82440,643527
102002,286,Explorer,6/7/2022,939229,271582,667647
102009,287,Explorer,3/24/2021,709438,277212,432226
102016,288,Member,4/5/2021,461092,133427,327665
102023,289,Member,10/12/2020,279921,85437,194484
102030,290,Member,9/6/2020,322706,172301,150405
102037,291,Member,8/5/2021,477755,232280,245475
102044,292,Explorer,5/13/2021,628461,459663,168798
102051,293,Explorer,7/21/2020,866691,85668,781023
102058,294,Explorer,6/27/2020,959796,506458,453338
102065,295,Explorer,7/2/2021,727903,372126,355777
102072,296,Explorer,3/16/2022,641951,414039,227912
102079,297,Explorer,7/5/2021,854271,423579,430692
102086,298,Explorer,7/19/2021,719234,209427,509807
102093,299,Member,9/30/2021,277692,11673,266019
102100,300,Explorer,10/14/2021,892277,459140,433137
102107,301,Member,2/6/2021,323028,2238,320790
102114,302,Explorer,11/24/2020,707115,378616,328499
102121,303,Member,6/2/2022,324754,308432,16322
102128,304,Explorer,11/27/2021,864688,826211,38477
102135,305,Member,9/23/2021,377523,10820,366703
102142,306,Member,4/18/2021,201414,16038,185376
102149,307,Explorer,3/27/2022,943466,91893,851573
102156,308,Member,3/21/2022,244828,77861,166967
102163,309,Member,3/25/2022,286822,267771,19051
102170,310,Explorer,8/14/2020,975768,766980,208788
102177,311,Explorer,9/23/2020,957601,770499,187102
102184,312,Member,11/10/2021,229216,132171,97045
102191,313,Explorer,6/9/2020,806095,387721,418374
102198,314,Member,11/28/2021,458007,169627,288380
102205,315,Explorer,8/15/2020,990291,857660,132631
102212,316,Explorer,5/16/2022,605086,462838,142248
102219,317,Explorer,2/4/2022,884007,557957,326050
102226,318,Explorer,8/3/2020,821291,212028,609263
102233,319,Member,4/29/2022,432101,426081,6020
102240,320,Explorer,12/2/2020,965127,645306,319821
102247,321,Member,2/23/2021,174850,170255,4595
102254,322,Explorer,11/11/2021,988881,369461,619420
102261,323,Member,3/15/2021,375387,319388,55999
102268,324,Member,5/28/2021,435940,331768,104172
102275,325,Member,8/30/2021,291181,29336,261845
102282,326,Member,12/13/2020,293722,158175,135547
102289,327,Explorer,4/10/2022,889495,644116,245379
102296,328,Explorer,7/12/2020,834126,540856,293270
102303,329,Member,9/2/2020,374512,345462,29050
102310,330,Explorer,6/19/2021,766618,708340,58278
102317,331,Explorer,5/22/2021,874865,628958,245907
102324,332,Member,8/29/2021,338680,54449,284231
102331,333,Member,1/9/2022,281000,206369,74631
102338,334,Member,6/29/2020,275177,377,274800
102345,335,Explorer,3/30/2022,977216,435079,542137
102352,336,Explorer,10/4/2020,794697,685960,108737
102359,337,Explorer,4/22/2021,996042,763882,232160
102366,338,Member,9/19/2020,110758,108010,2748
102373,339,Member,2/7/2022,153125,73961,79164
102380,340,Explorer,8/16/2021,833290,717431,115859
102387,341,Member,10/2/2021,234755,192375,42380
102394,342,Member,4/12/2021,420013,50842,369171
102401,343,Member,12/4/2021,366525,3895,362630
102408,344,Member,10/12/2021,269659,264107,5552
102415,345,Member,3/4/2021,271514,115387,156127
102422,346,Explorer,6/15/2021,951002,596771,354231
102429,347,Explorer,12/30/2020,622869,271734,351135
102436,348,Explorer,5/13/2022,921127,184216,736911
102443,349,Member,7/8/2021,177804,78388,99416
102450,350,Explorer,3/11/2022,640854,493723,147131
102457,351,Member,6/18/2021,468361,186863,281498
102464,352,Member,1/29/2021,189249,185081,4168
102471,353,Explorer,7/20/2020,717033,440924,276109
102478,354,Explorer,4/16/2021,711091,223680,487411
102485,355,Explorer,7/28/2021,630682,170036,460646
102492,356,Member,10/8/2021,103524,88702,14822
102499,357,Explorer,9/7/2021,679597,22619,656978
102506,358,Member,10/26/2020,295025,285793,9232
102513,359,Member,11/12/2021,254112,37993,216119
102520,360,Member,11/21/2021,250358,167834,82524
102527,361,Explorer,9/27/2021,764115,758508,5607
102534,362,Explorer,9/25/2020,723555,710015,13540
102541,363,Explorer,1/28/2022,826543,781800,44743
102548,364,Explorer,8/15/2021,916132,429897,486235
102555,365,Explorer,5/12/2021,951096,351898,599198
102562,366,Explorer,1/3/2022,742667,300644,442023
102569,367,Explorer,4/14/2021,920053,307572,612481
102576,368,Explorer,3/20/2022,922406,709823,212583
102583,369,Member,8/11/2021,112685,10437,102248
102590,370,Member,2/27/2022,448652,105651,343001
102597,371,Member,3/1/2021,256362,45508,210854
102604,372,Explorer,4/28/2021,956125,594883,361242
102611,373,Member,8/9/2020,359515,294666,64849
102618,374,Explorer,5/3/2021,956365,901843,54522
102625,375,Member,6/11/2021,236872,91931,144941
102632,376,Member,5/21/2021,171025,136206,34819
102639,377,Member,4/15/2022,241711,236322,5389
102646,378,Member,1/12/2021,243183,234556,8627
102653,379,Explorer,10/6/2021,923341,359422,563919
102660,380,Member,11/27/2020,308657,147369,161288
102667,381,Member,3/6/2022,358207,270296,87911
102674,382,Member,6/12/2021,428353,193368,234985
102681,383,Member,6/3/2021,464676,267364,197312
102688,384,Explorer,4/5/2021,683113,596456,86657
102695,385,Member,11/27/2020,166545,160689,5856
102702,386,Member,1/28/2022,366412,130182,236230
102709,387,Member,3/21/2021,227954,102012,125942
102716,388,Explorer,4/19/2021,674023,456622,217401
102723,389,Explorer,9/6/2020,840186,773988,66198
102730,390,Explorer,4/4/2021,842888,218923,623965
102737,391,Member,2/18/2022,103279,59556,43723
102744,392,Explorer,12/15/2021,911856,604586,307270
102751,393,Member,1/29/2022,465219,92917,372302
102758,394,Explorer,9/23/2021,850349,675933,174416
102765,395,Explorer,6/13/2020,877522,128962,748560
102772,396,Explorer,9/30/2021,668226,432584,235642
102779,397,Explorer,8/3/2021,625553,453805,171748
102786,398,Member,2/23/2022,496215,36151,460064
102793,399,Member,1/23/2021,148016,104096,43920
102800,400,Explorer,3/2/2022,999840,395893,603947
102807,401,Member,4/7/2021,166044,99204,66840
102814,402,Explorer,2/6/2022,835607,305233,530374
102821,403,Explorer,8/1/2021,659406,476335,183071
102828,404,Member,4/14/2021,118420,92865,25555
102835,405,Member,6/28/2021,144971,142597,2374
102842,406,Member,7/8/2021,287113,111591,175522
102849,407,Explorer,9/4/2021,756923,382248,374675
102856,408,Member,10/27/2021,423750,303265,120485
102863,409,Member,10/18/2020,175827,76490,99337
102870,410,Explorer,4/9/2022,776471,118238,658233
102877,411,Explorer,8/1/2020,659281,259414,399867
102884,412,Explorer,12/15/2020,947110,716850,230260
102891,413,Explorer,3/16/2022,701892,491054,210838
102898,414,Explorer,2/11/2022,645654,122922,522732
102905,415,Member,8/17/2021,270051,265414,4637
102912,416,Member,8/19/2020,162655,9759,152896
102919,417,Member,2/10/2021,437970,120741,317229
102926,418,Member,9/25/2020,470844,99670,371174
102933,419,Explorer,10/30/2021,788002,376204,411798
102940,420,Member,11/23/2021,372312,89472,282840
102947,421,Member,3/21/2021,364234,119197,245037
102954,422,Member,8/9/2020,176574,47747,128827
102961,423,Explorer,7/31/2020,911130,232548,678582
102968,424,Member,7/26/2021,419416,124178,295238
102975,425,Explorer,4/11/2022,939467,454281,485186
102982,426,Member,3/12/2021,260861,222,260639
102989,427,Member,9/16/2021,321855,198244,123611
102996,428,Member,6/20/2021,302551,96846,205705
103003,429,Member,10/10/2020,401265,337376,63889
103010,430,Member,3/30/2022,463189,75033,388156
103017,431,Member,10/11/2021,323554,304877,18677
103024,432,Explorer,2/23/2022,727898,473205,254693
103031,433,Explorer,6/25/2021,939411,886565,52846
103038,434,Explorer,12/30/2020,691422,324288,367134
103045,435,Explorer,12/31/2020,967932,114175,853757
103052,436,Member,7/6/2021,385463,236528,148935
103059,437,Member,12/6/2021,389077,119233,269844
103066,438,Member,8/16/2021,353130,320670,32460
103073,439,Explorer,4/15/2022,686455,519727,166728
103080,440,Member,4/30/2021,324276,9193,315083
103087,441,Explorer,3/23/2022,782396,580270,202126
103094,442,Member,11/30/2021,428937,51480,377457
103101,443,Member,7/7/2020,302398,58651,243747
103108,444,Member,11/28/2020,432235,120255,311980
103115,445,Member,8/12/2021,173594,107583,66011
103122,446,Explorer,2/26/2021,843499,618919,224580
103129,447,Explorer,3/15/2022,778097,566017,212080
103136,448,Member,1/24/2022,222792,16150,206642
103143,449,Member,4/1/2022,197397,140586,56811
103150,450,Member,9/22/2020,318039,153988,164051
103157,451,Explorer,6/3/2022,773106,209697,563409
103164,452,Explorer,1/14/2022,838759,813934,24825
103171,453,Member,12/5/2020,105246,96546,8700
103178,454,Member,8/30/2021,476078,139435,336643
103185,455,Member,6/2/2022,463859,173322,290537
103192,456,Explorer,7/26/2020,912514,651432,261082
103199,457,Member,10/11/2021,467549,161503,306046
103206,458,Explorer,11/18/2020,948174,685286,262888
103213,459,Member,3/30/2022,178456,116573,61883
103220,460,Explorer,7/5/2020,631015,556061,74954
103227,461,Explorer,6/22/2021,792751,489342,303409
103234,462,Explorer,11/11/2021,771789,529373,242416
103241,463,Explorer,2/15/2022,713112,175245,537867
103248,464,Member,12/2/2021,290049,101925,188124
103255,465,Member,6/26/2020,307405,10954,296451
103262,466,Explorer,5/7/2022,753910,455105,298805
103269,467,Explorer,1/22/2021,995384,579856,415528
103276,468,Member,4/7/2021,385986,212974,173012
103283,469,Explorer,10/2/2020,932934,4747,928187
103290,470,Member,8/2/2020,116920,83592,33328
103297,471,Explorer,2/9/2021,921038,370957,550081
103304,472,Explorer,8/28/2021,998462,20637,977825
103311,473,Explorer,9/11/2020,818289,340044,478245
103318,474,Explorer,2/15/2021,961183,259257,701926
103325,475,Explorer,2/9/2021,700709,682325,18384
103332,476,Explorer,4/15/2022,826529,687902,138627
103339,477,Member,5/30/2021,284460,199081,85379
103346,478,Explorer,11/9/2021,899914,409900,490014
103353,479,Explorer,11/18/2021,719041,412451,306590
103360,480,Member,2/1/2021,234973,97149,137824
103367,481,Explorer,6/25/2021,752625,639287,113338
103374,482,Explorer,8/4/2021,949332,414737,534595
103381,483,Member,10/1/2020,469565,105461,364104
103388,484,Explorer,8/31/2020,784365,206113,578252
103395,485,Explorer,3/25/2022,847963,16171,831792
103402,486,Explorer,6/20/2020,983650,397534,586116
103409,487,Member,2/24/2022,132015,83268,48747
103416,488,Member,8/15/2021,280383,223289,57094
103423,489,Explorer,11/10/2020,895199,779160,116039
103430,490,Explorer,3/11/2021,827903,163138,664765
103437,491,Member,6/7/2022,278024,241983,36041
103444,492,Member,1/5/2021,163771,135583,28188
103451,493,Member,7/26/2021,393154,277615,115539
103458,494,Explorer,12/11/2020,802737,758838,43899
103465,495,Explorer,8/19/2021,690156,387889,302267
103472,496,Member,2/17/2022,233523,93751,139772
103479,497,Explorer,5/19/2022,623345,555658,67687
103486,498,Member,8/28/2021,444843,282089,162754
103493,499,Member,8/26/2020,133685,56681,77004
103500,500,Explorer,2/3/2022,850670,817268,33402
103507,501,Member,3/30/2021,492326,37321,455005
103514,502,Member,4/9/2022,428882,175757,253125
103521,503,Explorer,9/21/2020,649609,87394,562215
103528,504,Member,9/23/2020,416792,17506,399286
103535,505,Explorer,5/13/2021,607789,601317,6472
103542,506,Explorer,9/26/2021,604892,417729,187163
103549,507,Member,8/6/2021,116849,70329,46520
103556,508,Member,6/7/2021,405571,171850,233721
103563,509,Member,8/27/2021,129917,59082,70835
103570,510,Explorer,6/12/2020,606058,500646,105412
103577,511,Member,2/24/2022,246401,36956,209445
103584,512,Member,10/9/2021,127538,97427,30111
103591,513,Explorer,5/11/2021,922454,594851,327603
103598,514,Explorer,8/4/2020,747466,45157,702309
103605,515,Member,6/16/2020,344671,280892,63779
103612,516,Member,12/23/2021,116523,39981,76542
103619,517,Member,9/23/2021,454376,302785,151591
103626,518,Explorer,4/12/2021,697474,296862,400612
103633,519,Explorer,12/25/2021,887699,118946,768753
103640,520,Member,12/8/2020,475945,428136,47809
103647,521,Explorer,8/30/2021,930070,572481,357589
103654,522,Member,8/13/2021,141229,53496,87733
103661,523,Explorer,5/28/2021,634153,47251,586902
103668,524,Member,5/22/2022,207529,115642,91887
103675,525,Member,4/26/2022,434409,222974,211435
103682,526,Explorer,3/17/2022,677593,168166,509427
103689,527,Explorer,12/3/2020,682066,290283,391783
103696,528,Explorer,5/29/2022,645975,139924,506051
103703,529,Member,7/11/2020,216896,99361,117535
103710,530,Member,2/10/2022,274439,72965,201474
103717,531,Explorer,1/27/2022,783011,14586,768425
103724,532,Member,9/27/2021,376867,307212,69655
103731,533,Explorer,4/26/2022,996135,25597,970538
103738,534,Member,12/28/2020,407665,273936,133729
103745,535,Member,4/8/2021,478706,103494,375212
103752,536,Explorer,8/29/2020,739214,355686,383528
103759,537,Member,7/31/2021,362052,72539,289513
103766,538,Member,10/23/2020,497455,397127,100328
103773,539,Member,4/30/2021,313829,121078,192751
103780,540,Explorer,6/24/2021,725451,537077,188374
103787,541,Member,12/20/2020,397881,187297,210584
103794,542,Member,2/5/2022,351751,153437,198314
103801,543,Explorer,10/15/2020,961294,933739,27555
103808,544,Explorer,9/23/2021,660110,49645,610465
103815,545,Explorer,11/22/2021,949991,527778,422213
103822,546,Explorer,10/11/2020,864693,424482,440211
103829,547,Member,3/1/2021,372518,298580,73938
103836,548,Explorer,11/11/2021,990746,846775,143971
103843,549,Explorer,2/8/2022,842033,700398,141635
103850,550,Member,10/2/2020,417185,301989,115196
103857,551,Member,6/16/2020,190984,152879,38105
103864,552,Explorer,7/19/2021,919418,900594,18824
103871,553,Explorer,2/23/2021,654055,406653,247402
103878,554,Explorer,11/27/2020,947509,836394,111115
103885,555,Explorer,10/14/2021,954320,419962,534358
103892,556,Explorer,3/9/2022,919775,459613,460162
103899,557,Explorer,7/31/2021,869748,25625,844123
103906,558,Member,12/3/2020,193134,55846,137288
103913,559,Member,7/8/2021,424717,154011,270706
103920,560,Explorer,11/5/2020,769763,390546,379217
103927,561,Explorer,12/8/2021,737822,699842,37980
103934,562,Member,7/19/2021,444283,417233,27050
103941,563,Explorer,1/21/2021,874492,671736,202756
103948,564,Explorer,11/10/2021,926764,783262,143502
103955,565,Explorer,11/17/2021,709690,164218,545472
103962,566,Member,1/3/2021,209995,169531,40464
103969,567,Member,3/4/2022,298576,114145,184431
103976,568,Explorer,1/10/2022,799104,776552,22552
103983,569,Explorer,2/13/2021,636760,467374,169386
103990,570,Member,9/21/2020,438244,302485,135759
103997,571,Member,10/11/2021,250311,227005,23306
104004,572,Explorer,8/15/2021,837538,209136,628402
104011,573,Member,5/3/2021,472846,403737,69109
104018,574,Member,8/3/2021,318124,240785,77339
104025,575,Member,12/18/2020,130106,7990,122116
104032,576,Member,3/19/2021,376949,159813,217136
104039,577,Member,7/21/2020,204538,143159,61379
104046,578,Member,12/10/2021,327114,282197,44917
104053,579,Explorer,11/29/2021,801451,95050,706401
104060,580,Explorer,4/6/2021,842471,353006,489465
104067,581,Member,6/18/2021,235072,134744,100328
104074,582,Member,5/11/2022,280760,278139,2621
104081,583,Member,4/23/2022,495386,314406,180980
104088,584,Explorer,5/28/2021,975396,924982,50414
104095,585,Explorer,12/12/2020,759720,293970,465750
104102,586,Explorer,5/9/2021,939077,75829,863248
104109,587,Explorer,2/5/2022,875044,406082,468962
104116,588,Explorer,2/23/2021,856259,572211,284048
104123,589,Explorer,12/19/2021,699276,54648,644628
104130,590,Explorer,9/15/2021,855840,283457,572383
104137,591,Member,5/26/2021,494990,66143,428847
104144,592,Explorer,11/1/2020,964037,311315,652722
104151,593,Member,4/28/2021,191377,140423,50954
104158,594,Member,1/30/2021,466752,227271,239481
104165,595,Explorer,12/14/2020,669465,111479,557986
104172,596,Explorer,3/11/2022,733610,610616,122994
104179,597,Member,12/11/2020,491408,31360,460048
104186,598,Member,11/17/2020,271060,31161,239899
104193,599,Member,3/7/2021,365677,40010,325667
104200,600,Member,11/23/2020,250739,146251,104488
104207,601,Member,12/9/2021,133172,5519,127653
104214,602,Member,10/11/2021,284239,78815,205424
104221,603,Explorer,11/18/2021,834286,593106,241180
104228,604,Explorer,11/6/2020,923319,637083,286236
104235,605,Explorer,11/3/2020,760670,646312,114358
104242,606,Explorer,1/2/2021,896153,611989,284164
104249,607,Member,3/1/2021,405244,208159,197085
104256,608,Explorer,9/22/2021,651662,245111,406551
104263,609,Member,12/4/2021,361780,166946,194834
104270,610,Member,8/12/2020,276170,187961,88209
104277,611,Explorer,5/14/2021,675794,254969,420825
104284,612,Member,5/23/2022,421918,274047,147871
104291,613,Member,2/14/2021,279553,219473,60080
104298,614,Explorer,7/4/2021,949665,604477,345188
104305,615,Member,8/3/2020,482321,29521,452800
104312,616,Member,10/18/2020,329616,94685,234931
104319,617,Member,5/1/2022,490787,324979,165808
104326,618,Member,11/13/2020,463311,82202,381109
104333,619,Explorer,5/11/2021,935177,612204,322973
104340,620,Member,3/13/2021,434243,346080,88163
104347,621,Explorer,9/6/2021,895980,411759,484221
104354,622,Explorer,8/3/2020,833669,590814,242855
104361,623,Explorer,4/25/2021,653175,354422,298753
104368,624,Member,2/17/2021,214805,11016,203789
104375,625,Member,11/7/2020,421492,33485,388007
104382,626,Explorer,10/2/2021,934442,624354,310088
104389,627,Member,10/21/2021,396100,135610,260490
104396,628,Member,3/2/2021,275449,44563,230886
104403,629,Explorer,11/5/2021,767383,594394,172989
104410,630,Member,1/29/2021,455129,355542,99587
104417,631,Member,5/18/2021,407592,376985,30607
104424,632,Member,1/4/2022,257887,194579,63308
104431,633,Explorer,5/26/2021,709412,453811,255601
104438,634,Explorer,7/12/2020,883858,300594,583264
104445,635,Explorer,7/16/2021,694561,344568,349993
104452,636,Explorer,8/7/2021,646448,16972,629476
104459,637,Explorer,7/2/2020,903411,715234,188177
104466,638,Explorer,10/3/2020,812095,365383,446712
104473,639,Member,10/20/2020,126036,96899,29137
104480,640,Member,12/23/2021,351919,251999,99920
104487,641,Member,3/2/2022,398605,95420,303185
104494,642,Explorer,8/19/2021,646895,438311,208584
104501,643,Explorer,6/16/2020,631006,211327,419679
104508,644,Member,1/29/2022,204389,66561,137828
104515,645,Member,10/2/2020,201510,76741,124769
104522,646,Member,3/30/2021,291543,233676,57867
104529,647,Explorer,4/23/2022,661990,384847,277143
104536,648,Explorer,10/2/2020,826485,540515,285970
104543,649,Explorer,2/4/2021,890329,879159,11170
104550,650,Member,7/30/2020,450241,146565,303676
104557,651,Explorer,9/18/2021,938666,390532,548134
104564,652,Explorer,6/30/2021,990639,261525,729114
104571,653,Explorer,10/26/2020,922456,753493,168963
104578,654,Member,8/28/2021,405098,11984,393114
104585,655,Member,12/13/2021,128532,31717,96815
104592,656,Explorer,9/10/2021,670054,572881,97173
104599,657,Member,4/18/2022,138154,54482,83672
104606,658,Member,10/22/2021,277168,178105,99063
104613,659,Member,8/14/2020,482175,322202,159973
104620,660,Member,2/12/2021,180145,175892,4253
104627,661,Member,6/13/2020,297096,99399,197697
104634,662,Explorer,8/19/2020,741769,439276,302493
104641,663,Member,1/13/2022,390576,194157,196419
104648,664,Explorer,8/6/2021,904132,470213,433919
104655,665,Explorer,1/5/2021,604283,471730,132553
104662,666,Member,6/20/2020,110223,96460,13763
104669,667,Explorer,10/14/2021,959620,497364,462256
104676,668,Member,8/23/2021,361520,241679,119841
104683,669,Explorer,1/15/2022,677295,612834,64461
104690,670,Member,8/8/2020,491457,322933,168524
104697,671,Explorer,8/19/2020,823950,762011,61939
104704,672,Member,11/1/2021,221094,79813,141281
104711,673,Explorer,7/10/2020,859447,410285,449162
104718,674,Explorer,9/12/2020,621379,560241,61138
104725,675,Explorer,11/29/2020,671800,611824,59976
104732,676,Explorer,12/20/2020,984564,694785,289779
104739,677,Explorer,8/25/2021,846386,386519,459867
104746,678,Explorer,4/29/2022,831727,541625,290102
104753,679,Member,1/15/2021,419859,339665,80194
104760,680,Member,12/25/2021,125712,98430,27282
104767,681,Explorer,3/30/2021,753899,613178,140721
104774,682,Explorer,4/1/2021,918425,645303,273122
104781,683,Member,5/8/2022,121826,23012,98814
104788,684,Explorer,11/21/2020,829999,703673,126326
104795,685,Member,1/7/2022,248016,161749,86267
104802,686,Member,12/2/2020,174759,105416,69343
104809,687,Explorer,6/5/2022,857148,756964,100184
104816,688,Member,4/8/2021,187324,83640,103684
104823,689,Explorer,8/19/2021,973311,589994,383317
104830,690,Explorer,7/31/2021,711680,647155,64525
104837,691,Member,11/8/2021,481983,452923,29060
104844,692,Member,2/1/2022,160095,144860,15235
104851,693,Explorer,12/16/2021,657682,408089,249593
104858,694,Explorer,6/11/2021,744795,156645,588150
104865,695,Explorer,2/27/2022,625437,46103,579334
104872,696,Member,5/24/2022,123661,70695,52966
104879,697,Member,2/21/2022,386745,6423,380322
104886,698,Explorer,12/23/2020,920967,53534,867433
104893,699,Member,11/4/2020,303366,262759,40607
104900,700,Explorer,1/8/2022,863394,344482,518912
104907,701,Member,3/15/2022,313948,71414,242534
104914,702,Member,8/8/2020,132919,64157,68762
104921,703,Member,10/6/2020,119917,40280,79637
104928,704,Member,12/1/2021,416499,198809,217690
104935,705,Explorer,8/25/2021,992868,621677,371191
104942,706,Explorer,6/3/2021,660758,586530,74228
104949,707,Member,7/29/2021,164824,146716,18108
104956,708,Member,11/11/2020,316173,237985,78188
104963,709,Explorer,7/24/2021,860156,557702,302454
104970,710,Member,10/31/2020,383751,56796,326955
104977,711,Explorer,4/4/2021,707269,370684,336585
104984,712,Explorer,8/18/2021,725384,34488,690896
104991,713,Explorer,6/26/2021,934073,27769,906304
104998,714,Member,2/3/2022,347990,303661,44329
105005,715,Explorer,1/16/2021,682215,232345,449870
105012,716,Member,5/22/2021,135674,71654,64020
105019,717,Member,3/1/2021,265218,238952,26266
105026,718,Member,4/2/2021,352675,281925,70750
105033,719,Member,1/27/2022,378430,355754,22676
105040,720,Member,12/16/2021,430211,287132,143079
105047,721,Explorer,8/10/2021,942582,134534,808048
105054,722,Member,5/6/2021,342438,240175,102263
105061,723,Member,6/15/2021,494044,455030,39014
105068,724,Explorer,2/18/2022,898853,508218,390635
105075,725,Member,2/15/2022,479486,327262,152224
105082,726,Member,8/22/2020,249107,127793,121314
105089,727,Member,2/17/2021,169109,143279,25830
105096,728,Explorer,5/25/2022,842668,177083,665585
105103,729,Explorer,10/17/2020,784964,231288,553676
105110,730,Member,2/11/2021,227083,91218,135865
105117,731,Explorer,3/30/2022,897719,661168,236551
105124,732,Explorer,1/26/2022,771388,256225,515163
105131,733,Member,5/31/2021,277020,114344,162676
105138,734,Member,10/21/2021,406825,154670,252155
105145,735,Explorer,8/13/2020,963953,730967,232986
105152,736,Member,5/29/2022,306066,113506,192560
105159,737,Member,6/2/2022,433548,5428,428120
105166,738,Explorer,6/4/2022,971356,386111,585245
105173,739,Member,6/14/2021,383614,362747,20867
105180,740,Member,9/15/2020,412429,384156,28273
105187,741,Member,11/26/2021,437764,280250,157514
105194,742,Member,10/4/2020,190548,175273,15275
105201,743,Explorer,11/27/2021,933593,541287,392306
105208,744,Explorer,10/13/2020,820502,590618,229884
105215,745,Explorer,11/14/2020,889448,388063,501385
105222,746,Member,9/27/2020,265783,57439,208344
105229,747,Explorer,5/12/2022,724904,137943,586961
105236,748,Member,12/9/2020,306248,250354,55894
105243,749,Explorer,1/5/2022,751272,130841,620431
105250,750,Member,3/17/2022,345755,295900,49855
105257,751,Explorer,6/1/2022,748312,256878,491434
105264,752,Explorer,4/2/2022,716499,396214,320285
105271,753,Member,12/15/2021,431480,373675,57805
105278,754,Explorer,4/23/2022,797252,455038,342214
105285,755,Explorer,11/29/2020,931539,850199,81340
105292,756,Member,9/29/2021,194426,160344,34082
105299,757,Explorer,5/19/2021,896932,621819,275113
105306,758,Explorer,11/6/2021,852218,334252,517966
105313,759,Explorer,11/22/2021,725857,114881,610976
105320,760,Member,4/12/2022,393769,73658,320111
105327,761,Member,4/2/2022,199545,58927,140618
105334,762,Explorer,2/28/2022,924048,149927,774121
105341,763,Member,3/14/2022,223536,18156,205380
105348,764,Member,5/29/2021,493949,216993,276956
105355,765,Explorer,5/17/2022,773716,715042,58674
105362,766,Member,9/4/2020,365015,170133,194882
105369,767,Explorer,3/23/2022,935954,779368,156586
105376,768,Member,1/23/2021,315172,190787,124385
105383,769,Explorer,12/3/2021,743361,555319,188042
105390,770,Explorer,6/11/2021,817532,297413,520119
105397,771,Member,6/25/2020,217026,49199,167827
105404,772,Explorer,5/12/2021,802442,254607,547835
105411,773,Member,12/7/2020,427852,15924,411928
105418,774,Member,1/6/2022,471397,395914,75483
105425,775,Member,11/2/2021,145226,48318,96908
105432,776,Member,11/30/2021,218926,24413,194513
105439,777,Explorer,11/19/2020,974795,222499,752296
105446,778,Member,11/21/2020,329548,273951,55597
105453,779,Explorer,3/25/2022,994063,676432,317631
105460,780,Member,8/1/2021,247805,38162,209643
105467,781,Member,1/20/2021,184795,97921,86874
105474,782,Explorer,5/16/2021,975616,436431,539185
105481,783,Explorer,12/2/2020,699507,375525,323982
105488,784,Explorer,2/20/2021,637376,134572,502804
105495,785,Member,2/21/2021,411685,156091,255594
105502,786,Explorer,5/8/2021,743065,382605,360460
105509,787,Member,3/24/2022,190554,30465,160089
105516,788,Explorer,10/20/2020,613591,108058,505533
105523,789,Explorer,4/21/2022,699757,1184,698573
105530,790,Explorer,7/18/2021,638148,254817,383331
105537,791,Member,6/12/2020,172116,121745,50371
105544,792,Explorer,10/27/2020,898551,305264,593287
105551,793,Member,7/30/2020,396748,245864,150884
105558,794,Member,5/8/2021,377688,333824,43864
105565,795,Member,1/17/2022,324383,200291,124092
105572,796,Explorer,5/28/2021,978559,552512,426047
105579,797,Explorer,12/13/2020,840639,329723,510916
105586,798,Explorer,7/25/2021,846585,648428,198157
105593,799,Member,6/1/2021,206877,151176,55701
105600,800,Member,10/16/2020,355066,188090,166976
105607,801,Explorer,8/4/2020,627173,338866,288307
105614,802,Explorer,8/11/2021,649739,120818,528921
105621,803,Explorer,9/15/2020,978971,342663,636308
105628,804,Member,12/5/2020,468030,271375,196655
105635,805,Member,2/23/2022,356470,87468,269002
105642,806,Member,1/16/2021,178626,176034,2592
105649,807,Explorer,11/28/2020,871326,399742,471584
105656,808,Explorer,7/20/2020,802901,405504,397397
105663,809,Member,6/6/2022,353313,12163,341150
105670,810,Member,3/6/2021,316480,197466,119014
105677,811,Member,5/11/2022,445582,236085,209497
105684,812,Member,7/17/2020,181255,29488,151767
105691,813,Member,3/4/2021,415030,413974,1056
105698,814,Explorer,11/5/2020,794528,17471,777057
105705,815,Explorer,4/6/2021,709759,387223,322536
105712,816,Member,5/19/2021,106035,87560,18475
105719,817,Explorer,10/24/2021,852630,121633,730997
105726,818,Explorer,10/20/2021,941652,438904,502748
105733,819,Member,12/7/2020,246779,34650,212129
105740,820,Member,8/16/2021,101230,94276,6954
105747,821,Explorer,11/22/2020,835843,562727,273116
105754,822,Member,10/24/2021,192757,3716,189041
105761,823,Explorer,8/10/2021,952684,483081,469603
105768,824,Explorer,2/27/2022,832254,205323,626931
105775,825,Member,1/9/2022,496820,169904,326916
105782,826,Member,4/15/2022,175030,91713,83317
105789,827,Member,12/3/2021,396735,319920,76815
105796,828,Explorer,6/19/2020,881560,542364,339196
105803,829,Member,1/10/2021,406758,208753,198005
105810,830,Explorer,4/27/2021,676267,439194,237073
105817,831,Explorer,3/26/2022,970714,14629,956085
105824,832,Member,11/18/2020,265140,233849,31291
105831,833,Member,3/17/2022,228203,78565,149638
105838,834,Member,4/30/2022,415745,249584,166161
105845,835,Member,5/13/2021,399221,366960,32261
105852,836,Explorer,2/5/2022,992056,483007,509049
105859,837,Member,10/21/2020,366930,84672,282258
105866,838,Explorer,4/11/2022,704998,41713,663285
105873,839,Member,10/18/2020,127577,74989,52588
105880,840,Member,3/13/2022,167328,57389,109939
105887,841,Member,12/27/2020,242042,22625,219417
105894,842,Explorer,4/6/2022,846301,420234,426067
105901,843,Member,8/17/2020,265310,68247,197063
105908,844,Explorer,4/6/2022,855974,470496,385478
105915,845,Explorer,12/3/2021,871937,486431,385506
105922,846,Explorer,8/7/2020,639483,255132,384351
105929,847,Member,11/27/2020,258743,216325,42418
105936,848,Explorer,11/16/2021,964816,947930,16886
105943,849,Member,10/20/2020,100750,95,100655
105950,850,Member,7/11/2021,417516,36925,380591
105957,851,Member,7/7/2021,368531,12566,355965
105964,852,Member,9/24/2020,439670,298304,141366
105971,853,Member,8/8/2021,171952,70555,101397
105978,854,Member,11/20/2020,405568,376424,29144
105985,855,Member,10/19/2020,244648,50682,193966
105992,856,Explorer,7/6/2020,867310,570024,297286
105999,857,Explorer,11/30/2021,653214,592194,61020
106006,858,Explorer,10/22/2021,715625,173433,542192
106013,859,Explorer,7/13/2020,863701,589745,273956
106020,860,Member,9/24/2021,237698,152475,85223
106027,861,Explorer,9/25/2020,609806,405740,204066
106034,862,Member,12/7/2021,392777,239153,153624
106041,863,Member,10/3/2020,391111,58903,332208
106048,864,Member,3/6/2022,176588,77612,98976
106055,865,Member,6/22/2021,102463,19846,82617
106062,866,Member,7/4/2020,387746,118053,269693
106069,867,Explorer,7/16/2020,620922,491584,129338
106076,868,Member,2/17/2021,212438,174700,37738
106083,869,Member,5/3/2021,182351,27185,155166
106090,870,Explorer,11/17/2021,871092,728292,142800
106097,871,Member,8/19/2020,339476,16770,322706
106104,872,Explorer,6/13/2021,997620,69328,928292
106111,873,Explorer,12/5/2020,713553,314050,399503
106118,874,Explorer,2/7/2022,881046,431018,450028
106125,875,Member,1/10/2021,130932,123383,7549
106132,876,Member,1/13/2022,162042,10731,151311
106139,877,Member,2/14/2021,160917,56514,104403
106146,878,Explorer,8/5/2021,726344,112332,614012
106153,879,Explorer,1/5/2022,719567,452027,267540
106160,880,Member,4/7/2022,245452,161496,83956
106167,881,Member,12/30/2021,293218,886,292332
106174,882,Explorer,3/21/2022,778146,403889,374257
106181,883,Explorer,10/2/2021,904155,770558,133597
106188,884,Explorer,5/25/2022,943120,782577,160543
106195,885,Member,1/2/2022,313760,183124,130636
106202,886,Explorer,2/11/2021,956496,656539,299957
106209,887,Member,6/24/2021,220299,169203,51096
106216,888,Explorer,4/17/2022,738619,557541,181078
106223,889,Member,11/17/2021,359501,305471,54030
106230,890,Explorer,7/21/2021,702648,557724,144924
106237,891,Explorer,7/11/2020,916114,539515,376599
106244,892,Explorer,11/15/2020,640556,618897,21659
106251,893,Member,1/6/2021,385075,239885,145190
106258,894,Member,10/5/2020,425858,48186,377672
106265,895,Member,2/3/2022,482155,258266,223889
106272,896,Member,11/6/2021,379875,180466,199409
106279,897,Member,11/26/2020,147462,25001,122461
106286,898,Member,5/14/2021,212355,107005,105350
106293,899,Explorer,6/26/2021,936170,200650,735520
106300,900,Member,6/29/2020,262279,31813,230466
106307,901,Explorer,2/22/2021,943870,83015,860855
106314,902,Member,7/15/2020,243271,182930,60341
106321,903,Explorer,4/7/2021,838108,73573,764535
106328,904,Member,6/15/2020,234518,105626,128892
106335,905,Member,8/17/2020,398054,72047,326007
106342,906,Explorer,9/26/2020,860316,620271,240045
106349,907,Member,4/18/2021,418163,184980,233183
106356,908,Member,5/10/2021,273138,980,272158
106363,909,Explorer,2/22/2022,930801,388868,541933
106370,910,Explorer,3/28/2021,825624,90943,734681
106377,911,Member,5/1/2021,276598,118662,157936
106384,912,Explorer,9/11/2020,870259,86586,783673
106391,913,Member,12/16/2021,429110,322212,106898
106398,914,Explorer,4/6/2021,831504,696145,135359
106405,915,Explorer,1/5/2021,623539,121067,502472
106412,916,Explorer,6/5/2021,750909,477028,273881
106419,917,Member,11/22/2020,328343,90255,238088
106426,918,Explorer,10/11/2020,755574,234534,521040
106433,919,Explorer,7/29/2021,918239,105445,812794
106440,920,Explorer,10/26/2020,754819,429973,324846
106447,921,Explorer,3/1/2022,705575,392253,313322
106454,922,Explorer,10/22/2021,698395,137380,561015
106461,923,Member,12/25/2020,439369,144882,294487
106468,924,Member,3/23/2022,305721,58373,247348
106475,925,Explorer,7/25/2020,725367,194932,530435
106482,926,Member,4/8/2021,128276,82828,45448
106489,927,Member,11/12/2021,420093,98287,321806
106496,928,Member,11/1/2021,372064,50396,321668
106503,929,Member,11/22/2020,497557,393029,104528
106510,930,Member,1/3/2022,297736,182062,115674
106517,931,Member,11/26/2021,199688,60959,138729
106524,932,Explorer,6/23/2020,868910,443673,425237
106531,933,Member,4/7/2021,341075,164719,176356
106538,934,Member,7/2/2020,244733,47573,197160
106545,935,Member,5/25/2022,281957,230598,51359
106552,936,Member,5/2/2022,119455,109603,9852
106559,937,Member,10/8/2020,190019,143286,46733
106566,938,Member,8/4/2021,183966,45432,138534
106573,939,Member,5/4/2022,400349,286673,113676
106580,940,Explorer,5/6/2021,906521,47129,859392
106587,941,Explorer,6/21/2021,959182,274644,684538
106594,942,Explorer,8/25/2021,930379,291560,638819
106601,943,Explorer,3/31/2022,814460,570062,244398
106608,944,Explorer,10/2/2021,864341,199847,664494
106615,945,Explorer,11/8/2020,871013,767625,103388
106622,946,Member,3/5/2022,340733,11155,329578
106629,947,Member,4/21/2021,355886,131154,224732
106636,948,Member,4/27/2022,217460,47665,169795
106643,949,Member,2/17/2021,116920,101866,15054
106650,950,Member,9/2/2021,417210,325313,91897
106657,951,Member,4/27/2022,457615,48243,409372
106664,952,Member,6/16/2020,373769,189998,183771
106671,953,Explorer,1/30/2022,757667,599202,158465
106678,954,Explorer,3/20/2022,866452,650918,215534
106685,955,Member,7/4/2020,198899,22139,176760
106692,956,Explorer,12/24/2020,763982,102346,661636
106699,957,Member,12/27/2020,416567,190491,226076
106706,958,Explorer,6/24/2020,647437,260026,387411
106713,959,Explorer,9/6/2020,647085,545685,101400
106720,960,Member,1/18/2021,214756,3224,211532
106727,961,Explorer,12/11/2021,734632,375158,359474
106734,962,Member,10/1/2020,298646,77259,221387
106741,963,Explorer,8/18/2021,970071,929007,41064
106748,964,Explorer,7/14/2020,674178,581384,92794
106755,965,Explorer,7/11/2020,908322,127167,781155
106762,966,Member,12/13/2021,413146,307186,105960
106769,967,Explorer,3/6/2022,777108,215514,561594
106776,968,Member,1/9/2021,404765,163381,241384
106783,969,Member,7/29/2021,195712,100510,95202
106790,970,Explorer,5/14/2022,958899,359595,599304
106797,971,Explorer,5/8/2021,619949,185758,434191
106804,972,Member,6/25/2021,195132,31307,163825
106811,973,Explorer,2/8/2021,719132,226952,492180
106818,974,Explorer,12/17/2021,911893,410611,501282
106825,975,Member,2/15/2021,114383,31160,83223
106832,976,Explorer,8/14/2020,907163,610868,296295
106839,977,Explorer,11/4/2020,973069,9816,963253
106846,978,Member,4/1/2021,128979,43032,85947
106853,979,Explorer,4/8/2021,689958,144598,545360
106860,980,Explorer,8/6/2020,675754,515385,160369
106867,981,Explorer,7/9/2020,777958,308196,469762
106874,982,Member,11/26/2021,339720,270271,69449
106881,983,Explorer,3/16/2022,638452,75239,563213
106888,984,Member,3/15/2022,262174,72965,189209
106895,985,Member,11/24/2020,367585,40384,327201
106902,986,Explorer,1/28/2022,654407,383439,270968
106909,987,Member,7/27/2020,209464,46369,163095
106916,988,Explorer,12/9/2021,983995,132091,851904
106923,989,Member,12/3/2021,144092,96188,47904
106930,990,Explorer,6/24/2021,989492,357490,632002
106937,991,Member,5/10/2021,165679,109384,56295
106944,992,Explorer,6/14/2020,719558,355135,364423
106951,993,Explorer,2/15/2021,680221,286094,394127
106958,994,Explorer,9/10/2020,627245,388025,239220
106965,995,Member,7/25/2021,377073,335377,41696
106972,996,Explorer,5/21/2022,967697,792885,174812
106979,997,Member,9/3/2021,385024,164326,220698
106986,998,Explorer,12/2/2020,715112,130777,584335
106993,999,Member,4/13/2021,265957,25204,240753
107000,1000,Explorer,2/22/2022,715746,655280,60466
